game_date,team_home,team_away,pts_home,pts_away,reb_home,reb_away,ast_home,ast_away,fg_pct_home,fg_pct_away,fg3_pct_home,fg3_pct_away,total_points,point_diff,home_win
2024-11-04,ATL,BOS,93,123,43,50,23,27,41.6,48.5,19.4,32.7,216,-30,False
2024-11-04,BOS,ATL,123,93,50,43,27,23,48.5,41.6,32.7,19.4,216,30,True
2024-11-04,BRK,MEM,106,104,37,44,28,29,47.6,47.3,36.1,26.7,210,2,True
2024-11-04,CHI,UTA,126,135,36,49,36,35,47.4,53.9,37.8,44.4,261,-9,False
2024-11-04,CHO,MIN,93,114,38,45,19,23,39.8,49.4,23.8,47.4,207,-21,False
2024-11-04,CLE,MIL,116,114,39,49,28,21,50.5,48.8,45.9,48.6,230,2,True
2024-11-04,DAL,IND,127,134,38,46,29,30,51.7,56.8,41.7,40.6,261,-7,False
2024-11-04,DEN,TOR,121,119,44,41,29,38,49.4,45.6,32.3,33.3,240,2,True
2024-11-04,DET,LAL,115,103,55,37,22,28,46.9,43.5,23.5,36.0,218,12,True
2024-11-04,GSW,WAS,125,112,56,47,29,29,45.4,43.8,32.4,23.3,237,13,True
2024-11-04,HOU,NYK,109,97,50,39,21,20,48.9,38.6,24.2,39.3,206,12,True
2024-11-04,IND,DAL,134,127,46,38,30,29,56.8,51.7,40.6,41.7,261,7,True
2024-11-04,LAC,SAS,113,104,44,45,25,22,45.6,44.2,51.4,26.8,217,9,True
2024-11-04,LAL,DET,103,115,37,55,28,22,43.5,46.9,36.0,23.5,218,-12,False
2024-11-04,MEM,BRK,104,106,44,37,29,28,47.3,47.6,26.7,36.1,210,-2,False
2024-11-04,MIA,SAC,110,111,36,39,24,23,43.5,51.2,41.7,37.0,221,-1,False
2024-11-04,MIL,CLE,114,116,49,39,21,28,48.8,50.5,48.6,45.9,230,-2,False
2024-11-04,MIN,CHO,114,93,45,38,23,19,49.4,39.8,47.4,23.8,207,21,True
2024-11-04,NOP,POR,100,118,34,38,24,21,45.2,54.8,28.6,34.5,218,-18,False
2024-11-04,NYK,HOU,97,109,39,50,20,21,38.6,48.9,39.3,24.2,206,-12,False
2024-11-04,OKC,ORL,102,86,42,41,23,20,45.9,35.4,38.7,14.7,188,16,True
2024-11-04,ORL,OKC,86,102,41,42,20,23,35.4,45.9,14.7,38.7,188,-16,False
2024-11-04,PHI,PHO,116,118,38,43,27,24,46.0,51.2,39.2,34.4,234,-2,False
2024-11-04,PHO,PHI,118,116,43,38,24,27,51.2,46.0,34.4,39.2,234,2,True
2024-11-04,POR,NOP,118,100,38,34,21,24,54.8,45.2,34.5,28.6,218,18,True
2024-11-04,SAC,MIA,111,110,39,36,23,24,51.2,43.5,37.0,41.7,221,1,True
2024-11-04,SAS,LAC,104,113,45,44,22,25,44.2,45.6,26.8,51.4,217,-9,False
2024-11-04,TOR,DEN,119,121,41,44,38,29,45.6,49.4,33.3,32.3,240,-2,False
2024-11-04,UTA,CHI,135,126,49,36,35,36,53.9,47.4,44.4,37.8,261,9,True
2024-11-04,WAS,GSW,112,125,47,56,29,29,43.8,45.4,23.3,32.4,237,-13,False
2024-11-12,ATL,BOS,117,116,44,34,35,28,50.5,50.7,31.2,40.0,233,1,True
2024-11-12,BOS,ATL,116,117,34,44,28,35,50.7,50.5,40.0,31.2,233,-1,False
2024-11-12,CHO,ORL,89,114,48,43,22,25,40.5,46.2,34.2,29.5,203,-25,False
2024-11-12,DAL,GSW,117,120,40,50,26,29,52.4,47.9,32.4,34.1,237,-3,False
2024-11-12,DET,MIA,123,121,56,43,32,25,46.7,46.5,36.1,37.8,244,2,True
2024-11-12,GSW,DAL,120,117,50,40,29,26,47.9,52.4,34.1,32.4,237,3,True
2024-11-12,MIA,DET,121,123,43,56,25,32,46.5,46.7,37.8,36.1,244,-2,False
2024-11-12,MIL,TOR,99,85,47,54,25,20,40.4,34.9,28.6,36.0,184,14,True
2024-11-12,MIN,POR,108,122,32,39,22,30,50.7,51.2,37.1,56.2,230,-14,False
2024-11-12,NYK,PHI,111,99,47,40,31,19,49.4,37.3,29.0,33.3,210,12,True
2024-11-12,ORL,CHO,114,89,43,48,25,22,46.2,40.5,29.5,34.2,203,25,True
2024-11-12,PHI,NYK,99,111,40,47,19,31,37.3,49.4,33.3,29.0,210,-12,False
2024-11-12,PHO,UTA,120,112,42,39,21,32,50.0,48.9,46.2,39.5,232,8,True
2024-11-12,POR,MIN,122,108,39,32,30,22,51.2,50.7,56.2,37.1,230,14,True
2024-11-12,TOR,MIL,85,99,54,47,20,25,34.9,40.4,36.0,28.6,184,-14,False
2024-11-12,UTA,PHO,112,120,39,42,32,21,48.9,50.0,39.5,46.2,232,-8,False
2025-01-18,ATL,BOS,119,115,55,53,27,23,47.3,38.5,24.3,28.8,234,4,True
2025-01-18,BOS,ATL,115,119,53,55,23,27,38.5,47.3,28.8,24.3,234,-4,False
2025-01-18,CLE,MIN,124,117,47,42,27,27,45.7,47.8,35.4,39.5,241,7,True
2025-01-18,DET,PHO,121,125,43,50,22,25,46.8,50.0,27.3,28.0,246,-4,False
2025-01-18,GSW,WAS,122,114,55,44,24,24,46.9,44.2,34.1,48.9,236,8,True
2025-01-18,HOU,POR,125,103,61,40,25,28,44.4,45.3,45.2,33.3,228,22,True
2025-01-18,IND,PHI,115,102,50,32,30,21,53.0,42.7,32.4,29.4,217,13,True
2025-01-18,MIN,CLE,117,124,42,47,27,27,47.8,45.7,39.5,35.4,241,-7,False
2025-01-18,PHI,IND,102,115,32,50,21,30,42.7,53.0,29.4,32.4,217,-13,False
2025-01-18,PHO,DET,125,121,50,43,25,22,50.0,46.8,28.0,27.3,246,4,True
2025-01-18,POR,HOU,103,125,40,61,28,25,45.3,44.4,33.3,45.2,228,-22,False
2025-01-18,WAS,GSW,114,122,44,55,24,24,44.2,46.9,48.9,34.1,236,-8,False
2024-10-23,ATL,BRK,120,116,45,43,25,21,48.8,44.0,32.1,39.5,236,4,True
2024-10-23,BRK,ATL,116,120,43,45,21,25,44.0,48.8,39.5,32.1,236,-4,False
2024-10-23,CHI,NOP,111,123,47,42,26,29,48.8,46.4,29.4,37.8,234,-12,False
2024-10-23,CHO,HOU,110,105,56,43,20,19,44.7,36.9,38.5,30.2,215,5,True
2024-10-23,CLE,TOR,136,106,36,38,29,25,58.6,41.9,46.7,38.7,242,30,True
2024-10-23,DET,IND,109,115,38,39,22,32,43.2,50.6,27.3,29.0,224,-6,False
2024-10-23,GSW,POR,140,104,57,42,38,21,51.6,39.1,41.7,23.5,244,36,True
2024-10-23,HOU,CHO,105,110,43,56,19,20,36.9,44.7,30.2,38.5,215,-5,False
2024-10-23,IND,DET,115,109,39,38,32,22,50.6,43.2,29.0,27.3,224,6,True
2024-10-23,LAC,PHO,113,116,51,42,27,25,45.7,48.7,27.6,39.5,229,-3,False
2024-10-23,MEM,UTA,126,124,41,49,28,21,47.3,47.1,37.8,38.5,250,2,True
2024-10-23,MIA,ORL,97,116,41,57,24,28,39.0,42.7,32.4,36.7,213,-19,False
2024-10-23,MIL,PHI,124,109,46,49,27,18,53.8,41.8,43.2,25.8,233,15,True
2024-10-23,NOP,CHI,123,111,42,47,29,26,46.4,48.8,37.8,29.4,234,12,True
2024-10-23,ORL,MIA,116,97,57,41,28,24,42.7,39.0,36.7,32.4,213,19,True
2024-10-23,PHI,MIL,109,124,49,46,18,27,41.8,53.8,25.8,43.2,233,-15,False
2024-10-23,PHO,LAC,116,113,42,51,25,27,48.7,45.7,39.5,27.6,229,3,True
2024-10-23,POR,GSW,104,140,42,57,21,38,39.1,51.6,23.5,41.7,244,-36,False
2024-10-23,TOR,CLE,106,136,38,36,25,29,41.9,58.6,38.7,46.7,242,-30,False
2024-10-23,UTA,MEM,124,126,49,41,21,28,47.1,47.3,38.5,37.8,250,-2,False
2024-11-09,ATL,CHI,113,125,39,47,31,30,46.1,50.0,31.0,33.3,238,-12,False
2024-11-09,BRK,CLE,100,105,36,33,21,24,44.7,54.1,34.9,35.7,205,-5,False
2024-11-09,CHI,ATL,125,113,47,39,30,31,50.0,46.1,33.3,31.0,238,12,True
2024-11-09,CLE,BRK,105,100,33,36,24,21,54.1,44.7,35.7,34.9,205,5,True
2024-11-09,LAC,TOR,105,103,47,44,18,26,46.1,42.1,38.5,29.7,208,2,True
2024-11-09,SAS,UTA,110,111,37,45,29,23,44.7,46.3,36.2,30.3,221,-1,False
2024-11-09,TOR,LAC,103,105,44,47,26,18,42.1,46.1,29.7,38.5,208,-2,False
2024-11-09,UTA,SAS,111,110,45,37,23,29,46.3,44.7,30.3,36.2,221,1,True
2024-11-22,ATL,CHI,122,136,42,41,32,36,45.8,57.0,29.4,44.2,258,-14,False
2024-11-22,BOS,WAS,108,96,43,48,22,19,42.4,43.3,23.9,25.0,204,12,True
2024-11-22,BRK,PHI,98,113,34,40,28,25,49.4,44.6,35.1,37.2,211,-15,False
2024-11-22,CHI,ATL,136,122,41,42,36,32,57.0,45.8,44.2,29.4,258,14,True
2024-11-22,DAL,DEN,123,120,44,42,24,33,50.5,47.8,37.0,51.7,243,3,True
2024-11-22,DEN,DAL,120,123,42,44,33,24,47.8,50.5,51.7,37.0,243,-3,False
2024-11-22,GSW,NOP,112,108,52,43,27,28,44.8,44.6,32.4,30.8,220,4,True
2024-11-22,HOU,POR,116,88,51,45,27,17,45.2,33.0,38.5,25.6,204,28,True
2024-11-22,IND,MIL,117,129,46,44,30,33,47.3,53.3,32.4,47.2,246,-12,False
2024-11-22,LAC,SAC,104,88,54,48,27,19,41.5,38.6,23.8,20.0,192,16,True
2024-11-22,MIL,IND,129,117,44,46,33,30,53.3,47.3,47.2,32.4,246,12,True
2024-11-22,NOP,GSW,108,112,43,52,28,27,44.6,44.8,30.8,32.4,220,-4,False
2024-11-22,PHI,BRK,113,98,40,34,25,28,44.6,49.4,37.2,35.1,211,15,True
2024-11-22,POR,HOU,88,116,45,51,17,27,33.0,45.2,25.6,38.5,204,-28,False
2024-11-22,SAC,LAC,88,104,48,54,19,27,38.6,41.5,20.0,23.8,192,-16,False
2024-11-22,WAS,BOS,96,108,48,43,19,22,43.3,42.4,25.0,23.9,204,-12,False
2024-12-26,ATL,CHI,141,133,44,36,32,36,51.7,54.1,37.8,51.2,274,8,True
2024-12-26,BRK,MIL,111,105,38,39,25,23,47.6,49.4,42.1,39.5,216,6,True
2024-12-26,CHI,ATL,133,141,36,44,36,32,54.1,51.7,51.2,37.8,274,-8,False
2024-12-26,CHO,WAS,110,113,50,43,31,25,43.6,42.9,40.5,31.8,223,-3,False
2024-12-26,DET,SAC,114,113,44,44,25,20,41.8,47.6,38.6,35.9,227,1,True
2024-12-26,HOU,NOP,128,111,54,44,19,29,47.4,43.4,38.3,32.4,239,17,True
2024-12-26,IND,OKC,114,120,51,45,28,20,47.2,46.3,38.9,35.1,234,-6,False
2024-12-26,MEM,TOR,155,126,63,40,36,39,53.2,45.4,40.0,32.6,281,29,True
2024-12-26,MIA,ORL,89,88,35,42,21,14,40.8,44.2,50.0,17.2,177,1,True
2024-12-26,MIL,BRK,105,111,39,38,23,25,49.4,47.6,39.5,42.1,216,-6,False
2024-12-26,NOP,HOU,111,128,44,54,29,19,43.4,47.4,32.4,38.3,239,-17,False
2024-12-26,OKC,IND,120,114,45,51,20,28,46.3,47.2,35.1,38.9,234,6,True
2024-12-26,ORL,MIA,88,89,42,35,14,21,44.2,40.8,17.2,50.0,177,-1,False
2024-12-26,POR,UTA,122,120,43,46,26,26,50.6,47.7,39.5,50.0,242,2,True
2024-12-26,SAC,DET,113,114,44,44,20,25,47.6,41.8,35.9,38.6,227,-1,False
2024-12-26,TOR,MEM,126,155,40,63,39,36,45.4,53.2,32.6,40.0,281,-29,False
2024-12-26,UTA,POR,120,122,46,43,26,26,47.7,50.6,50.0,39.5,242,-2,False
2024-12-26,WAS,CHO,113,110,43,50,25,31,42.9,43.6,31.8,40.5,223,3,True
2025-01-15,ATL,CHI,110,94,51,53,28,23,41.0,44.3,30.2,22.2,204,16,True
2025-01-15,BOS,TOR,97,110,45,56,24,35,39.6,50.6,34.8,32.4,207,-13,False
2025-01-15,BRK,LAC,67,126,39,46,15,26,30.1,54.4,17.9,37.5,193,-59,False
2025-01-15,CHI,ATL,94,110,53,51,23,28,44.3,41.0,22.2,30.2,204,-16,False
2025-01-15,CHO,UTA,117,112,45,36,27,30,52.9,46.2,30.8,37.2,229,5,True
2025-01-15,DAL,NOP,116,119,45,49,27,24,47.8,44.3,34.3,33.3,235,-3,False
2025-01-15,DEN,HOU,108,128,36,40,22,28,53.3,52.1,48.3,44.7,236,-20,False
2025-01-15,GSW,MIN,116,115,45,41,26,21,48.8,44.2,50.0,45.9,231,1,True
2025-01-15,HOU,DEN,128,108,40,36,28,22,52.1,53.3,44.7,48.3,236,20,True
2025-01-15,LAC,BRK,126,67,46,39,26,15,54.4,30.1,37.5,17.9,193,59,True
2025-01-15,LAL,MIA,117,108,34,37,33,25,52.2,53.4,38.2,44.4,225,9,True
2025-01-15,MEM,SAS,129,115,52,44,28,22,49.5,44.9,42.1,37.2,244,14,True
2025-01-15,MIA,LAL,108,117,37,34,25,33,53.4,52.2,44.4,38.2,225,-9,False
2025-01-15,MIL,ORL,122,93,49,32,24,24,62.5,34.7,58.3,26.1,215,29,True
2025-01-15,MIN,GSW,115,116,41,45,21,26,44.2,48.8,45.9,50.0,231,-1,False
2025-01-15,NOP,DAL,119,116,49,45,24,27,44.3,47.8,33.3,34.3,235,3,True
2025-01-15,NYK,PHI,125,119,45,35,28,27,53.5,50.0,43.2,37.1,244,6,True
2025-01-15,ORL,MIL,93,122,32,49,24,24,34.7,62.5,26.1,58.3,215,-29,False
2025-01-15,PHI,NYK,119,125,35,45,27,28,50.0,53.5,37.1,43.2,244,-6,False
2025-01-15,SAS,MEM,115,129,44,52,22,28,44.9,49.5,37.2,42.1,244,-14,False
2025-01-15,TOR,BOS,110,97,56,45,35,24,50.6,39.6,32.4,34.8,207,13,True
2025-01-15,UTA,CHO,112,117,36,45,30,27,46.2,52.9,37.2,30.8,229,-5,False
2024-10-25,ATL,CHO,125,120,39,53,25,22,48.1,38.5,36.8,41.2,245,5,True
2024-10-25,BRK,ORL,101,116,37,39,22,28,42.2,52.0,37.8,50.0,217,-15,False
2024-10-25,CHI,MIL,133,122,46,47,30,24,47.9,49.5,44.7,32.5,255,11,True
2024-10-25,CHO,ATL,120,125,53,39,22,25,38.5,48.1,41.2,36.8,245,-5,False
2024-10-25,CLE,DET,113,101,39,42,28,25,51.2,46.9,38.2,40.6,214,12,True
2024-10-25,DET,CLE,101,113,42,39,25,28,46.9,51.2,40.6,38.2,214,-12,False
2024-10-25,GSW,UTA,127,86,60,45,35,18,48.1,31.5,40.0,21.4,213,41,True
2024-10-25,HOU,MEM,128,108,64,43,20,24,43.9,41.8,39.5,35.7,236,20,True
2024-10-25,IND,NYK,98,123,33,43,28,19,49.4,52.4,10.0,44.4,221,-25,False
2024-10-25,LAL,PHO,123,116,37,34,33,35,53.3,51.2,51.9,45.9,239,7,True
2024-10-25,MEM,HOU,108,128,43,64,24,20,41.8,43.9,35.7,39.5,236,-20,False
2024-10-25,MIL,CHI,122,133,47,46,24,30,49.5,47.9,32.5,44.7,255,-11,False
2024-10-25,NOP,POR,105,103,44,48,25,26,41.9,41.1,37.5,35.1,208,2,True
2024-10-25,NYK,IND,123,98,43,33,19,28,52.4,49.4,44.4,10.0,221,25,True
2024-10-25,ORL,BRK,116,101,39,37,28,22,52.0,42.2,50.0,37.8,217,15,True
2024-10-25,PHI,TOR,107,115,28,54,19,25,38.2,46.1,31.0,26.1,222,-8,False
2024-10-25,PHO,LAL,116,123,34,37,35,33,51.2,53.3,45.9,51.9,239,-7,False
2024-10-25,POR,NOP,103,105,48,44,26,25,41.1,41.9,35.1,37.5,208,-2,False
2024-10-25,TOR,PHI,115,107,54,28,25,19,46.1,38.2,26.1,31.0,222,8,True
2024-10-25,UTA,GSW,86,127,45,60,18,35,31.5,48.1,21.4,40.0,213,-41,False
2024-11-30,ATL,CHO,107,104,49,45,27,23,48.7,37.2,30.3,37.5,211,3,True
2024-11-30,CHO,ATL,104,107,45,49,23,27,37.2,48.7,37.5,30.3,211,-3,False
2024-11-30,DAL,UTA,106,94,48,53,30,20,45.6,35.8,38.5,23.1,200,12,True
2024-11-30,DET,PHI,96,111,42,50,22,19,38.5,49.4,27.5,35.5,207,-15,False
2024-11-30,GSW,PHO,105,113,43,45,28,31,41.3,48.1,35.0,51.4,218,-8,False
2024-11-30,MIL,WAS,124,114,38,41,31,24,51.2,47.1,45.7,28.1,238,10,True
2024-11-30,PHI,DET,111,96,50,42,19,22,49.4,38.5,35.5,27.5,207,15,True
2024-11-30,PHO,GSW,113,105,45,43,31,28,48.1,41.3,51.4,35.0,218,8,True
2024-11-30,UTA,DAL,94,106,53,48,20,30,35.8,45.6,23.1,38.5,200,-12,False
2024-11-30,WAS,MIL,114,124,41,38,24,31,47.1,51.2,28.1,45.7,238,-10,False
2024-11-27,ATL,CLE,135,124,51,44,39,31,47.4,46.3,47.6,31.2,259,11,True
2024-11-27,BRK,PHO,127,117,36,37,32,25,50.6,53.2,42.9,38.7,244,10,True
2024-11-27,CHI,ORL,119,133,37,39,30,30,52.9,51.1,38.1,38.5,252,-14,False
2024-11-27,CHO,MIA,94,98,43,44,22,21,37.8,45.2,33.3,37.8,192,-4,False
2024-11-27,CLE,ATL,124,135,44,51,31,39,46.3,47.4,31.2,47.6,259,-11,False
2024-11-27,DAL,NYK,129,114,43,33,27,20,56.5,46.5,51.5,24.1,243,15,True
2024-11-27,DEN,UTA,122,103,39,47,30,25,54.8,42.2,33.3,37.2,225,19,True
2024-11-27,DET,MEM,111,131,42,42,24,31,47.1,54.8,34.2,37.0,242,-20,False
2024-11-27,GSW,OKC,101,105,57,48,25,26,35.7,45.9,32.0,29.7,206,-4,False
2024-11-27,HOU,PHI,122,115,51,42,23,19,45.5,44.8,32.3,36.4,237,7,True
2024-11-27,IND,POR,121,114,47,38,27,31,48.9,50.6,40.6,45.7,235,7,True
2024-11-27,LAC,WAS,121,96,47,40,27,21,50.6,41.2,36.4,24.2,217,25,True
2024-11-27,LAL,SAS,119,101,46,38,31,26,53.3,42.4,38.2,35.0,220,18,True
2024-11-27,MEM,DET,131,111,42,42,31,24,54.8,47.1,37.0,34.2,242,20,True
2024-11-27,MIA,CHO,98,94,44,43,21,22,45.2,37.8,37.8,33.3,192,4,True
2024-11-27,MIN,SAC,104,115,33,47,25,28,44.6,48.9,35.9,32.4,219,-11,False
2024-11-27,NOP,TOR,93,119,47,52,24,38,38.7,49.5,31.4,40.4,212,-26,False
2024-11-27,NYK,DAL,114,129,33,43,20,27,46.5,56.5,24.1,51.5,243,-15,False
2024-11-27,OKC,GSW,105,101,48,57,26,25,45.9,35.7,29.7,32.0,206,4,True
2024-11-27,ORL,CHI,133,119,39,37,30,30,51.1,52.9,38.5,38.1,252,14,True
2024-11-27,PHI,HOU,115,122,42,51,19,23,44.8,45.5,36.4,32.3,237,-7,False
2024-11-27,PHO,BRK,117,127,37,36,25,32,53.2,50.6,38.7,42.9,244,-10,False
2024-11-27,POR,IND,114,121,38,47,31,27,50.6,48.9,45.7,40.6,235,-7,False
2024-11-27,SAC,MIN,115,104,47,33,28,25,48.9,44.6,32.4,35.9,219,11,True
2024-11-27,SAS,LAL,101,119,38,46,26,31,42.4,53.3,35.0,38.2,220,-18,False
2024-11-27,TOR,NOP,119,93,52,47,38,24,49.5,38.7,40.4,31.4,212,26,True
2024-11-27,UTA,DEN,103,122,47,39,25,30,42.2,54.8,37.2,33.3,225,-19,False
2024-11-27,WAS,LAC,96,121,40,47,21,27,41.2,50.6,24.2,36.4,217,-25,False
2024-11-29,ATL,CLE,117,101,53,40,33,21,51.8,40.9,41.2,28.9,218,16,True
2024-11-29,BOS,CHI,138,129,51,43,24,28,50.0,51.6,42.6,39.2,267,9,True
2024-11-29,BRK,ORL,100,123,35,40,22,29,49.4,53.0,48.3,51.4,223,-23,False
2024-11-29,CHI,BOS,129,138,43,51,28,24,51.6,50.0,39.2,42.6,267,-9,False
2024-11-29,CHO,NYK,98,99,39,44,25,20,40.4,44.4,31.9,37.5,197,-1,False
2024-11-29,CLE,ATL,101,117,40,53,21,33,40.9,51.8,28.9,41.2,218,-16,False
2024-11-29,DET,IND,130,106,44,32,35,23,57.8,48.2,47.4,36.4,236,24,True
2024-11-29,IND,DET,106,130,32,44,23,35,48.2,57.8,36.4,47.4,236,-24,False
2024-11-29,LAC,MIN,92,93,39,49,20,25,42.9,41.3,32.3,38.5,185,-1,False
2024-11-29,LAL,OKC,93,101,47,47,25,20,45.2,40.9,28.9,32.5,194,-8,False
2024-11-29,MEM,NOP,120,109,51,46,36,16,49.0,41.8,29.3,31.0,229,11,True
2024-11-29,MIA,TOR,121,111,33,46,32,34,45.7,53.8,38.9,37.9,232,10,True
2024-11-29,MIN,LAC,93,92,49,39,25,20,41.3,42.9,38.5,32.3,185,1,True
2024-11-29,NOP,MEM,109,120,46,51,16,36,41.8,49.0,31.0,29.3,229,-11,False
2024-11-29,NYK,CHO,99,98,44,39,20,25,44.4,40.4,37.5,31.9,197,1,True
2024-11-29,OKC,LAL,101,93,47,47,20,25,40.9,45.2,32.5,28.9,194,8,True
2024-11-29,ORL,BRK,123,100,40,35,29,22,53.0,49.4,51.4,48.3,223,23,True
2024-11-29,POR,SAC,115,106,40,41,27,29,51.1,44.9,29.7,35.7,221,9,True
2024-11-29,SAC,POR,106,115,41,40,29,27,44.9,51.1,35.7,29.7,221,-9,False
2024-11-29,TOR,MIA,111,121,46,33,34,32,53.8,45.7,37.9,38.9,232,-10,False
2025-01-30,ATL,CLE,115,137,36,49,28,34,45.6,58.2,33.3,33.3,252,-22,False
2025-01-30,CLE,ATL,137,115,49,36,34,28,58.2,45.6,33.3,33.3,252,22,True
2025-01-30,HOU,MEM,119,120,45,37,22,23,43.3,51.6,40.6,32.1,239,-1,False
2025-01-30,LAL,WAS,134,96,48,38,31,18,54.4,31.9,46.9,22.7,230,38,True
2025-01-30,MEM,HOU,120,119,37,45,23,22,51.6,43.3,32.1,40.6,239,1,True
2025-01-30,MIN,UTA,138,113,39,23,38,21,59.8,50.6,55.3,41.2,251,25,True
2025-01-30,ORL,POR,90,119,33,38,14,23,42.0,52.6,19.2,48.0,209,-29,False
2025-01-30,POR,ORL,119,90,38,33,23,14,52.6,42.0,48.0,19.2,209,29,True
2025-01-30,UTA,MIN,113,138,23,39,21,38,50.6,59.8,41.2,55.3,251,-25,False
2025-01-30,WAS,LAL,96,134,38,48,18,31,31.9,54.4,22.7,46.9,230,-38,False
2024-11-25,ATL,DAL,119,129,39,51,32,24,47.5,50.0,29.0,45.7,248,-10,False
2024-11-25,BOS,LAC,126,94,47,44,33,18,51.1,43.3,43.1,26.9,220,32,True
2024-11-25,BRK,GSW,128,120,42,43,23,32,49.4,48.4,44.4,41.3,248,8,True
2024-11-25,CHO,ORL,84,95,52,39,14,21,41.3,39.4,21.9,26.1,179,-11,False
2024-11-25,DAL,ATL,129,119,51,39,24,32,50.0,47.5,45.7,29.0,248,10,True
2024-11-25,DEN,NYK,118,145,33,43,23,45,44.6,60.9,33.3,52.8,263,-27,False
2024-11-25,DET,TOR,102,100,38,50,27,26,44.7,39.4,32.4,28.6,202,2,True
2024-11-25,GSW,BRK,120,128,43,42,32,23,48.4,49.4,41.3,44.4,248,-8,False
2024-11-25,IND,NOP,114,110,41,44,30,35,47.3,51.7,36.2,27.3,224,4,True
2024-11-25,LAC,BOS,94,126,44,47,18,33,43.3,51.1,26.9,43.1,220,-32,False
2024-11-25,MEM,POR,123,98,60,44,35,22,49.4,33.3,42.9,17.4,221,25,True
2024-11-25,NOP,IND,110,114,44,41,35,30,51.7,47.3,27.3,36.2,224,-4,False
2024-11-25,NYK,DEN,145,118,43,33,45,23,60.9,44.6,52.8,33.3,263,27,True
2024-11-25,OKC,SAC,130,109,44,31,28,24,55.8,48.3,45.2,25.0,239,21,True
2024-11-25,ORL,CHO,95,84,39,52,21,14,39.4,41.3,26.1,21.9,179,11,True
2024-11-25,POR,MEM,98,123,44,60,22,35,33.3,49.4,17.4,42.9,221,-25,False
2024-11-25,SAC,OKC,109,130,31,44,24,28,48.3,55.8,25.0,45.2,239,-21,False
2024-11-25,TOR,DET,100,102,50,38,26,27,39.4,44.7,28.6,32.4,202,-2,False
2024-12-08,ATL,DEN,111,141,45,43,26,43,40.6,62.9,22.5,44.4,252,-30,False
2024-12-08,BRK,MIL,113,118,30,31,24,26,50.6,57.4,45.7,48.4,231,-5,False
2024-12-08,CHI,PHI,100,108,35,56,29,25,40.7,46.7,35.2,25.0,208,-8,False
2024-12-08,CHO,IND,113,109,45,29,24,23,51.3,51.2,48.3,33.3,222,4,True
2024-12-08,CLE,MIA,113,122,36,47,25,27,47.7,47.7,42.4,43.2,235,-9,False
2024-12-08,DEN,ATL,141,111,43,45,43,26,62.9,40.6,44.4,22.5,252,30,True
2024-12-08,GSW,MIN,114,106,45,39,28,22,46.7,45.6,39.0,45.2,220,8,True
2024-12-08,HOU,LAC,117,106,50,33,23,21,48.8,44.6,36.6,32.4,223,11,True
2024-12-08,IND,CHO,109,113,29,45,23,24,51.2,51.3,33.3,48.3,222,-4,False
2024-12-08,LAC,HOU,106,117,33,50,21,23,44.6,48.8,32.4,36.6,223,-11,False
2024-12-08,LAL,POR,107,98,40,49,25,17,45.8,41.7,38.2,25.0,205,9,True
2024-12-08,MEM,WAS,140,112,46,52,34,20,52.1,43.0,39.5,18.8,252,28,True
2024-12-08,MIA,CLE,122,113,47,36,27,25,47.7,47.7,43.2,42.4,235,9,True
2024-12-08,MIL,BRK,118,113,31,30,26,24,57.4,50.6,48.4,45.7,231,5,True
2024-12-08,MIN,GSW,106,114,39,45,22,28,45.6,46.7,45.2,39.0,220,-8,False
2024-12-08,NOP,SAS,116,121,43,55,26,27,43.4,45.2,34.2,30.8,237,-5,False
2024-12-08,ORL,PHO,115,110,44,39,17,24,47.7,47.0,33.3,46.4,225,5,True
2024-12-08,PHI,CHI,108,100,56,35,25,29,46.7,40.7,25.0,35.2,208,8,True
2024-12-08,PHO,ORL,110,115,39,44,24,17,47.0,47.7,46.4,33.3,225,-5,False
2024-12-08,POR,LAL,98,107,49,40,17,25,41.7,45.8,25.0,38.2,205,-9,False
2024-12-08,SAC,UTA,141,97,43,38,39,21,57.0,38.8,50.0,35.7,238,44,True
2024-12-08,SAS,NOP,121,116,55,43,27,26,45.2,43.4,30.8,34.2,237,5,True
2024-12-08,UTA,SAC,97,141,38,43,21,39,38.8,57.0,35.7,50.0,238,-44,False
2024-12-08,WAS,MEM,112,140,52,46,20,34,43.0,52.1,18.8,39.5,252,-28,False
2025-01-01,ATL,DEN,120,139,44,43,34,44,45.0,56.4,34.8,40.0,259,-19,False
2025-01-01,BRK,TOR,113,130,32,39,28,36,48.3,59.1,29.7,50.0,243,-17,False
2025-01-01,CHI,WAS,107,125,44,42,28,36,44.6,49.5,29.8,47.2,232,-18,False
2025-01-01,DAL,HOU,99,110,38,35,19,16,53.3,47.2,39.3,32.0,209,-11,False
2025-01-01,DEN,ATL,139,120,43,44,44,34,56.4,45.0,40.0,34.8,259,19,True
2025-01-01,DET,ORL,105,96,49,33,25,18,51.9,40.7,41.4,22.9,201,9,True
2025-01-01,HOU,DAL,110,99,35,38,16,19,47.2,53.3,32.0,39.3,209,11,True
2025-01-01,MIA,NOP,119,108,38,31,34,25,53.0,50.0,41.2,26.5,227,11,True
2025-01-01,NOP,MIA,108,119,31,38,25,34,50.0,53.0,26.5,41.2,227,-11,False
2025-01-01,NYK,UTA,119,103,47,45,31,23,55.3,40.6,39.1,30.2,222,16,True
2025-01-01,ORL,DET,96,105,33,49,18,25,40.7,51.9,22.9,41.4,201,-9,False
2025-01-01,PHI,SAC,107,113,34,45,24,24,47.6,48.8,37.5,29.0,220,-6,False
2025-01-01,SAC,PHI,113,107,45,34,24,24,48.8,47.6,29.0,37.5,220,6,True
2025-01-01,TOR,BRK,130,113,39,32,36,28,59.1,48.3,50.0,29.7,243,17,True
2025-01-01,UTA,NYK,103,119,45,47,23,31,40.6,55.3,30.2,39.1,222,-16,False
2025-01-01,WAS,CHI,125,107,42,44,36,28,49.5,44.6,47.2,29.8,232,18,True
2024-11-08,ATL,DET,121,122,44,45,30,27,45.4,51.2,41.7,39.4,243,-1,False
2024-11-08,BOS,BRK,108,104,39,51,23,24,43.3,41.0,26.4,26.3,212,4,True
2024-11-08,BRK,BOS,104,108,51,39,24,23,41.0,43.3,26.3,26.4,212,-4,False
2024-11-08,CHO,IND,103,83,56,37,23,24,42.2,39.8,34.0,31.0,186,20,True
2024-11-08,CLE,GSW,136,117,43,40,33,32,54.1,48.0,47.6,31.0,253,19,True
2024-11-08,DAL,PHO,113,114,39,37,18,26,51.2,50.0,33.3,38.5,227,-1,False
2024-11-08,DEN,MIA,135,122,39,33,37,33,61.7,48.9,51.4,46.5,257,13,True
2024-11-08,DET,ATL,122,121,45,44,27,30,51.2,45.4,39.4,41.7,243,1,True
2024-11-08,GSW,CLE,117,136,40,43,32,33,48.0,54.1,31.0,47.6,253,-19,False
2024-11-08,HOU,OKC,107,126,48,41,19,24,43.3,51.1,36.7,37.8,233,-19,False
2024-11-08,IND,CHO,83,103,37,56,24,23,39.8,42.2,31.0,34.0,186,-20,False
2024-11-08,LAC,SAC,107,98,48,35,20,19,44.4,47.4,46.7,11.5,205,9,True
2024-11-08,LAL,PHI,116,106,45,44,28,28,51.8,40.6,45.7,33.3,222,10,True
2024-11-08,MEM,WAS,128,104,50,41,30,27,47.4,40.9,32.6,25.7,232,24,True
2024-11-08,MIA,DEN,122,135,33,39,33,37,48.9,61.7,46.5,51.4,257,-13,False
2024-11-08,MIL,NYK,94,116,41,48,20,35,43.4,47.3,23.3,30.4,210,-22,False
2024-11-08,MIN,POR,127,102,49,37,32,13,48.5,42.9,44.0,24.0,229,25,True
2024-11-08,NOP,ORL,88,115,31,43,18,28,38.1,52.3,32.3,25.0,203,-27,False
2024-11-08,NYK,MIL,116,94,48,41,35,20,47.3,43.4,30.4,23.3,210,22,True
2024-11-08,OKC,HOU,126,107,41,48,24,19,51.1,43.3,37.8,36.7,233,19,True
2024-11-08,ORL,NOP,115,88,43,31,28,18,52.3,38.1,25.0,32.3,203,27,True
2024-11-08,PHI,LAL,106,116,44,45,28,28,40.6,51.8,33.3,45.7,222,-10,False
2024-11-08,PHO,DAL,114,113,37,39,26,18,50.0,51.2,38.5,33.3,227,1,True
2024-11-08,POR,MIN,102,127,37,49,13,32,42.9,48.5,24.0,44.0,229,-25,False
2024-11-08,SAC,LAC,98,107,35,48,19,20,47.4,44.4,11.5,46.7,205,-9,False
2024-11-08,WAS,MEM,104,128,41,50,27,30,40.9,47.4,25.7,32.6,232,-24,False
2025-01-22,ATL,DET,104,114,47,51,25,27,37.9,50.0,15.8,35.3,218,-10,False
2025-01-22,BOS,LAC,117,113,32,40,24,24,45.6,52.2,38.0,32.1,230,4,True
2025-01-22,BRK,PHO,84,108,52,48,16,28,37.4,47.7,19.4,34.1,192,-24,False
2025-01-22,CHO,MEM,120,132,33,40,27,36,47.7,50.0,35.5,44.7,252,-12,False
2025-01-22,CLE,HOU,108,109,45,53,25,25,42.3,44.0,31.7,44.1,217,-1,False
2025-01-22,DAL,MIN,114,115,38,39,24,26,50.0,45.7,27.6,37.9,229,-1,False
2025-01-22,DET,ATL,114,104,51,47,27,25,50.0,37.9,35.3,15.8,218,10,True
2025-01-22,GSW,SAC,117,123,44,38,31,24,46.7,50.6,45.8,36.7,240,-6,False
2025-01-22,HOU,CLE,109,108,53,45,25,25,44.0,42.3,44.1,31.7,217,1,True
2025-01-22,LAC,BOS,113,117,40,32,24,24,52.2,45.6,32.1,38.0,230,-4,False
2025-01-22,MEM,CHO,132,120,40,33,36,27,50.0,47.7,44.7,35.5,252,12,True
2025-01-22,MIN,DAL,115,114,39,38,26,24,45.7,50.0,37.9,27.6,229,1,True
2025-01-22,OKC,UTA,123,114,39,52,20,25,46.3,46.7,30.8,37.8,237,9,True
2025-01-22,PHO,BRK,108,84,48,52,28,16,47.7,37.4,34.1,19.4,192,24,True
2025-01-22,SAC,GSW,123,117,38,44,24,31,50.6,46.7,36.7,45.8,240,6,True
2025-01-22,UTA,OKC,114,123,52,39,25,20,46.7,46.3,37.8,30.8,237,-9,False
2025-02-03,ATL,DET,132,130,37,41,27,31,51.9,51.8,43.2,33.3,262,2,True
2025-02-03,CHO,WAS,114,124,46,54,26,29,43.8,44.4,37.9,33.3,238,-10,False
2025-02-03,DEN,NOP,125,113,46,41,28,27,50.0,43.2,36.4,47.4,238,12,True
2025-02-03,DET,ATL,130,132,41,37,31,27,51.8,51.9,33.3,43.2,262,-2,False
2025-02-03,GSW,ORL,104,99,44,52,25,23,43.6,43.4,30.8,25.0,203,5,True
2025-02-03,HOU,NYK,118,124,50,40,27,24,46.2,50.5,28.6,23.1,242,-6,False
2025-02-03,IND,UTA,112,111,37,60,32,31,47.3,42.9,23.8,35.1,223,1,True
2025-02-03,MEM,SAS,128,109,47,48,33,31,48.5,45.1,38.9,33.3,237,19,True
2025-02-03,MIL,OKC,96,125,37,55,24,28,37.6,51.5,33.3,39.0,221,-29,False
2025-02-03,MIN,SAC,114,116,36,47,28,23,45.7,48.9,30.0,41.7,230,-2,False
2025-02-03,NOP,DEN,113,125,41,46,27,28,43.2,50.0,47.4,36.4,238,-12,False
2025-02-03,NYK,HOU,124,118,40,50,24,27,50.5,46.2,23.1,28.6,242,6,True
2025-02-03,OKC,MIL,125,96,55,37,28,24,51.5,37.6,39.0,33.3,221,29,True
2025-02-03,ORL,GSW,99,104,52,44,23,25,43.4,43.6,25.0,30.8,203,-5,False
2025-02-03,PHO,POR,119,121,43,48,28,30,47.1,44.9,35.7,40.0,240,-2,False
2025-02-03,POR,PHO,121,119,48,43,30,28,44.9,47.1,40.0,35.7,240,2,True
2025-02-03,SAC,MIN,116,114,47,36,23,28,48.9,45.7,41.7,30.0,230,2,True
2025-02-03,SAS,MEM,109,128,48,47,31,33,45.1,48.5,33.3,38.9,237,-19,False
2025-02-03,UTA,IND,111,112,60,37,31,32,42.9,47.3,35.1,23.8,223,-1,False
2025-02-03,WAS,CHO,124,114,54,46,29,26,44.4,43.8,33.3,37.9,238,10,True
2024-11-20,ATL,GSW,97,120,65,54,27,36,33.3,46.5,26.1,35.0,217,-23,False
2024-11-20,CHI,MIL,106,122,33,45,25,30,46.6,55.0,37.8,36.1,228,-16,False
2024-11-20,CLE,NOP,128,100,52,40,29,23,52.7,42.4,42.9,25.8,228,28,True
2024-11-20,GSW,ATL,120,97,54,65,36,27,46.5,33.3,35.0,26.1,217,23,True
2024-11-20,HOU,IND,130,113,47,36,25,19,46.1,53.0,33.3,22.7,243,17,True
2024-11-20,IND,HOU,113,130,36,47,19,25,53.0,46.1,22.7,33.3,243,-17,False
2024-11-20,LAC,ORL,104,93,49,24,22,21,49.4,44.0,50.0,22.9,197,11,True
2024-11-20,MEM,PHI,117,111,41,41,29,21,48.2,44.8,44.2,33.3,228,6,True
2024-11-20,MIL,CHI,122,106,45,33,30,25,55.0,46.6,36.1,37.8,228,16,True
2024-11-20,NOP,CLE,100,128,40,52,23,29,42.4,52.7,25.8,42.9,228,-28,False
2024-11-20,NYK,PHO,138,122,41,34,30,30,58.1,48.9,48.7,38.0,260,16,True
2024-11-20,OKC,POR,109,99,46,49,24,18,44.0,40.5,29.0,39.5,208,10,True
2024-11-20,ORL,LAC,93,104,24,49,21,22,44.0,49.4,22.9,50.0,197,-11,False
2024-11-20,PHI,MEM,111,117,41,41,21,29,44.8,48.2,33.3,44.2,228,-6,False
2024-11-20,PHO,NYK,122,138,34,41,30,30,48.9,58.1,38.0,48.7,260,-16,False
2024-11-20,POR,OKC,99,109,49,46,18,24,40.5,44.0,39.5,29.0,208,-10,False
2025-01-28,ATL,HOU,96,100,40,44,19,19,40.4,46.8,23.4,23.3,196,-4,False
2025-01-28,GSW,UTA,114,103,47,39,29,30,39.1,51.3,34.7,30.8,217,11,True
2025-01-28,HOU,ATL,100,96,44,40,19,19,46.8,40.4,23.3,23.4,196,4,True
2025-01-28,LAL,PHI,104,118,39,43,25,20,51.4,47.3,30.3,32.4,222,-14,False
2025-01-28,MIL,POR,112,125,36,52,26,26,50.6,51.1,31.4,42.9,237,-13,False
2025-01-28,PHI,LAL,118,104,43,39,20,25,47.3,51.4,32.4,30.3,222,14,True
2025-01-28,POR,MIL,125,112,52,36,26,26,51.1,50.6,42.9,31.4,237,13,True
2025-01-28,UTA,GSW,103,114,39,47,30,29,51.3,39.1,30.8,34.7,217,-11,False
2025-02-01,ATL,IND,127,132,44,41,31,35,50.0,54.4,37.8,36.4,259,-5,False
2025-02-01,BRK,HOU,110,98,46,44,24,18,49.4,40.0,37.0,30.8,208,12,True
2025-02-01,CHO,DEN,104,107,51,43,31,29,43.2,46.6,34.6,18.9,211,-3,False
2025-02-01,DEN,CHO,107,104,43,51,29,31,46.6,43.2,18.9,34.6,211,3,True
2025-02-01,HOU,BRK,98,110,44,46,18,24,40.0,49.4,30.8,37.0,208,-12,False
2025-02-01,IND,ATL,132,127,41,44,35,31,54.4,50.0,36.4,37.8,259,5,True
2025-02-01,LAL,NYK,128,112,37,44,26,33,58.0,46.3,47.5,35.7,240,16,True
2025-02-01,MIA,SAS,105,103,52,48,30,27,46.1,41.8,31.0,33.3,208,2,True
2025-02-01,MIN,WAS,103,105,47,44,29,26,40.9,45.8,30.0,45.5,208,-2,False
2025-02-01,NYK,LAL,112,128,44,37,33,26,46.3,58.0,35.7,47.5,240,-16,False
2025-02-01,OKC,SAC,144,110,70,37,37,25,53.3,40.0,41.3,25.0,254,34,True
2025-02-01,ORL,UTA,99,113,43,51,19,26,33.0,46.4,22.0,40.0,212,-14,False
2025-02-01,PHO,POR,108,127,37,43,21,24,45.2,51.7,30.3,29.0,235,-19,False
2025-02-01,POR,PHO,127,108,43,37,24,21,51.7,45.2,29.0,30.3,235,19,True
2025-02-01,SAC,OKC,110,144,37,70,25,37,40.0,53.3,25.0,41.3,254,-34,False
2025-02-01,SAS,MIA,103,105,48,52,27,30,41.8,46.1,33.3,31.0,208,-2,False
2025-02-01,UTA,ORL,113,99,51,43,26,19,46.4,33.0,40.0,22.0,212,14,True
2025-02-01,WAS,MIN,105,103,44,47,26,29,45.8,40.9,45.5,30.0,208,2,True
2025-01-04,ATL,LAC,105,131,43,48,30,36,43.2,55.2,34.8,36.1,236,-26,False
2025-01-04,BRK,PHI,94,123,39,50,22,31,41.5,51.2,34.1,37.5,217,-29,False
2025-01-04,CHI,NYK,139,126,43,49,36,27,54.3,49.5,54.1,26.7,265,13,True
2025-01-04,DEN,SAS,122,111,58,58,32,28,43.5,39.4,30.3,27.1,233,11,True
2025-01-04,DET,MIN,119,105,47,33,26,20,48.4,42.5,34.2,40.0,224,14,True
2025-01-04,GSW,MEM,121,113,29,43,32,29,52.4,52.3,53.5,33.3,234,8,True
2025-01-04,IND,PHO,126,108,47,36,35,30,47.9,48.7,37.5,40.0,234,18,True
2025-01-04,LAC,ATL,131,105,48,43,36,30,55.2,43.2,36.1,34.8,236,26,True
2025-01-04,MEM,GSW,113,121,43,29,29,32,52.3,52.4,33.3,53.5,234,-8,False
2025-01-04,MIA,UTA,100,136,32,57,25,31,43.8,52.0,25.7,41.3,236,-36,False
2025-01-04,MIL,POR,102,105,43,55,25,21,43.2,48.2,31.7,36.1,207,-3,False
2025-01-04,MIN,DET,105,119,33,47,20,26,42.5,48.4,40.0,34.2,224,-14,False
2025-01-04,NYK,CHI,126,139,49,43,27,36,49.5,54.3,26.7,54.1,265,-13,False
2025-01-04,PHI,BRK,123,94,50,39,31,22,51.2,41.5,37.5,34.1,217,29,True
2025-01-04,PHO,IND,108,126,36,47,30,35,48.7,47.9,40.0,37.5,234,-18,False
2025-01-04,POR,MIL,105,102,55,43,21,25,48.2,43.2,36.1,31.7,207,3,True
2025-01-04,SAS,DEN,111,122,58,58,28,32,39.4,43.5,27.1,30.3,233,-11,False
2025-01-04,UTA,MIA,136,100,57,32,31,25,52.0,43.8,41.3,25.7,236,36,True
2024-12-06,ATL,LAL,134,132,48,40,40,33,50.0,51.5,42.5,45.7,266,2,True
2024-12-06,BOS,MIL,111,105,41,51,27,16,46.0,42.6,32.1,37.9,216,6,True
2024-12-06,CHI,IND,123,132,38,46,33,33,47.4,56.5,42.0,60.0,255,-9,False
2024-12-06,GSW,MIN,90,107,41,48,21,32,39.0,45.5,28.2,33.3,197,-17,False
2024-12-06,IND,CHI,132,123,46,38,33,33,56.5,47.4,60.0,42.0,255,9,True
2024-12-06,LAL,ATL,132,134,40,48,33,40,51.5,50.0,45.7,42.5,266,-2,False
2024-12-06,MIL,BOS,105,111,51,41,16,27,42.6,46.0,37.9,32.1,216,-6,False
2024-12-06,MIN,GSW,107,90,48,41,32,21,45.5,39.0,33.3,28.2,197,17,True
2024-12-06,ORL,PHI,94,102,38,37,21,23,42.3,48.1,28.3,26.9,196,-8,False
2024-12-06,PHI,ORL,102,94,37,38,23,21,48.1,42.3,26.9,28.3,196,8,True
2024-12-06,POR,UTA,99,141,34,61,23,34,38.9,55.2,29.8,43.8,240,-42,False
2024-12-06,SAC,SAS,140,113,44,42,33,28,56.7,42.9,47.1,34.1,253,27,True
2024-12-06,SAS,SAC,113,140,42,44,28,33,42.9,56.7,34.1,47.1,253,-27,False
2024-12-06,UTA,POR,141,99,61,34,34,23,55.2,38.9,43.8,29.8,240,42,True
2025-01-03,ATL,LAL,102,119,39,56,22,28,41.0,48.9,17.6,43.3,221,-17,False
2025-01-03,BOS,HOU,109,86,41,37,20,9,50.6,36.4,48.7,27.8,195,23,True
2025-01-03,CHO,DET,94,98,45,51,25,21,41.2,41.9,30.0,32.4,192,-4,False
2025-01-03,CLE,DAL,134,122,46,53,38,29,53.1,43.0,37.5,27.3,256,12,True
2025-01-03,DAL,CLE,122,134,53,46,29,38,43.0,53.1,27.3,37.5,256,-12,False
2025-01-03,DEN,SAS,110,113,46,56,33,31,43.3,46.5,38.5,36.1,223,-3,False
2025-01-03,DET,CHO,98,94,51,45,21,25,41.9,41.2,32.4,30.0,192,4,True
2025-01-03,HOU,BOS,86,109,37,41,9,20,36.4,50.6,27.8,48.7,195,-23,False
2025-01-03,LAL,ATL,119,102,56,39,28,22,48.9,41.0,43.3,17.6,221,17,True
2025-01-03,MEM,SAC,133,138,51,37,31,32,48.3,49.5,45.9,44.7,271,-5,False
2025-01-03,NOP,WAS,132,120,37,48,36,28,50.0,53.6,43.9,32.1,252,12,True
2025-01-03,NYK,OKC,107,117,42,41,22,27,47.8,51.2,28.1,51.9,224,-10,False
2025-01-03,OKC,NYK,117,107,41,42,27,22,51.2,47.8,51.9,28.1,224,10,True
2025-01-03,ORL,TOR,106,97,42,37,32,28,46.8,47.5,43.2,34.5,203,9,True
2025-01-03,SAC,MEM,138,133,37,51,32,31,49.5,48.3,44.7,45.9,271,5,True
2025-01-03,SAS,DEN,113,110,56,46,31,33,46.5,43.3,36.1,38.5,223,3,True
2025-01-03,TOR,ORL,97,106,37,42,28,32,47.5,46.8,34.5,43.2,203,-9,False
2025-01-03,WAS,NOP,120,132,48,37,28,36,53.6,50.0,32.1,43.9,252,-12,False
2024-12-21,ATL,MEM,112,128,41,40,29,35,48.8,51.5,36.8,43.9,240,-16,False
2024-12-21,BOS,CHI,123,98,59,43,27,28,48.0,37.8,33.3,34.1,221,25,True
2024-12-21,BRK,UTA,94,105,50,45,24,25,40.4,47.7,17.5,34.1,199,-11,False
2024-12-21,CHI,BOS,98,123,43,59,28,27,37.8,48.0,34.1,33.3,221,-25,False
2024-12-21,CLE,PHI,126,99,49,41,31,13,53.3,40.0,51.2,32.4,225,27,True
2024-12-21,DAL,LAC,113,97,43,40,25,18,45.5,42.0,40.0,27.0,210,16,True
2024-12-21,DET,PHO,133,125,35,35,31,30,55.1,57.7,48.7,48.3,258,8,True
2024-12-21,GSW,MIN,113,103,45,45,30,27,46.0,41.9,38.1,36.8,216,10,True
2024-12-21,LAC,DAL,97,113,40,43,18,25,42.0,45.5,27.0,40.0,210,-16,False
2024-12-21,LAL,SAC,103,99,48,46,23,25,48.2,43.3,25.7,27.0,202,4,True
2024-12-21,MEM,ATL,128,112,40,41,35,29,51.5,48.8,43.9,36.8,240,16,True
2024-12-21,MIA,ORL,114,121,38,41,16,24,48.0,49.4,28.1,29.7,235,-7,False
2024-12-21,MIL,WAS,112,101,44,47,35,20,44.9,44.4,41.7,42.9,213,11,True
2024-12-21,MIN,GSW,103,113,45,45,27,30,41.9,46.0,36.8,38.1,216,-10,False
2024-12-21,NOP,NYK,93,104,45,42,23,24,41.0,43.7,35.3,40.5,197,-11,False
2024-12-21,NYK,NOP,104,93,42,45,24,23,43.7,41.0,40.5,35.3,197,11,True
2024-12-21,ORL,MIA,121,114,41,38,24,16,49.4,48.0,29.7,28.1,235,7,True
2024-12-21,PHI,CLE,99,126,41,49,13,31,40.0,53.3,32.4,51.2,225,-27,False
2024-12-21,PHO,DET,125,133,35,35,30,31,57.7,55.1,48.3,48.7,258,-8,False
2024-12-21,POR,SAS,94,114,44,49,21,33,39.6,47.3,27.9,27.8,208,-20,False
2024-12-21,SAC,LAL,99,103,46,48,25,23,43.3,48.2,27.0,25.7,202,-4,False
2024-12-21,SAS,POR,114,94,49,44,33,21,47.3,39.6,27.8,27.9,208,20,True
2024-12-21,UTA,BRK,105,94,45,50,25,24,47.7,40.4,34.1,17.5,199,11,True
2024-12-21,WAS,MIL,101,112,47,44,20,35,44.4,44.9,42.9,41.7,213,-11,False
2024-12-28,ATL,MIA,120,110,47,42,34,23,51.2,44.4,40.5,31.7,230,10,True
2024-12-28,CHI,MIL,116,111,52,43,33,27,47.4,40.2,38.9,33.3,227,5,True
2024-12-28,CHO,OKC,94,106,44,49,17,29,36.2,47.7,32.4,26.3,200,-12,False
2024-12-28,DAL,POR,122,126,40,50,20,27,48.3,50.0,39.5,42.3,248,-4,False
2024-12-28,DEN,DET,134,121,40,41,29,29,56.1,48.4,48.1,30.8,255,13,True
2024-12-28,DET,DEN,121,134,41,40,29,29,48.4,56.1,30.8,48.1,255,-13,False
2024-12-28,GSW,PHO,109,105,49,46,26,21,41.8,42.4,26.7,25.7,214,4,True
2024-12-28,LAL,SAC,132,122,33,39,33,38,59.7,51.0,53.8,27.5,254,10,True
2024-12-28,MIA,ATL,110,120,42,47,23,34,44.4,51.2,31.7,40.5,230,-10,False
2024-12-28,MIL,CHI,111,116,43,52,27,33,40.2,47.4,33.3,38.9,227,-5,False
2024-12-28,NYK,WAS,136,132,43,44,26,32,52.6,51.5,25.0,44.7,268,4,True
2024-12-28,OKC,CHO,106,94,49,44,29,17,47.7,36.2,26.3,32.4,200,12,True
2024-12-28,PHI,UTA,114,111,32,48,22,27,43.4,48.3,36.1,33.3,225,3,True
2024-12-28,PHO,GSW,105,109,46,49,21,26,42.4,41.8,25.7,26.7,214,-4,False
2024-12-28,POR,DAL,126,122,50,40,27,20,50.0,48.3,42.3,39.5,248,4,True
2024-12-28,SAC,LAL,122,132,39,33,38,33,51.0,59.7,27.5,53.8,254,-10,False
2024-12-28,UTA,PHI,111,114,48,32,27,22,48.3,43.4,33.3,36.1,225,-3,False
2024-12-28,WAS,NYK,132,136,44,43,32,26,51.5,52.6,44.7,25.0,268,-4,False
2024-12-04,ATL,MIL,119,104,55,40,29,23,43.7,42.3,28.1,33.3,223,15,True
2024-12-04,BOS,DET,130,120,43,34,30,27,47.9,51.2,39.6,51.3,250,10,True
2024-12-04,BRK,IND,99,90,43,39,24,20,43.2,42.7,33.3,24.2,189,9,True
2024-12-04,DET,BOS,120,130,34,43,27,30,51.2,47.9,51.3,39.6,250,-10,False
2024-12-04,IND,BRK,90,99,39,43,20,24,42.7,43.2,24.2,33.3,189,-9,False
2024-12-04,LAC,MIN,80,108,46,50,13,31,34.9,48.2,27.5,36.4,188,-28,False
2024-12-04,LAL,MIA,93,134,36,52,29,42,42.0,57.8,22.7,51.1,227,-41,False
2024-12-04,MIA,LAL,134,93,52,36,42,29,57.8,42.0,51.1,22.7,227,41,True
2024-12-04,MIL,ATL,104,119,40,55,23,29,42.3,43.7,33.3,28.1,223,-15,False
2024-12-04,MIN,LAC,108,80,50,46,31,13,48.2,34.9,36.4,27.5,188,28,True
2024-12-04,ORL,PHI,106,102,42,35,21,23,48.8,48.8,27.6,36.7,208,4,True
2024-12-04,PHI,ORL,102,106,35,42,23,21,48.8,48.8,36.7,27.6,208,-4,False
2024-12-14,ATL,MIL,102,110,44,47,23,28,42.7,45.3,41.7,31.1,212,-8,False
2024-12-14,HOU,OKC,96,111,49,43,17,19,36.5,45.0,23.9,36.7,207,-15,False
2024-12-14,MIL,ATL,110,102,47,44,28,23,45.3,42.7,31.1,41.7,212,8,True
2024-12-14,OKC,HOU,111,96,43,49,19,17,45.0,36.5,36.7,23.9,207,15,True
2025-02-07,ATL,MIL,115,110,52,43,29,28,48.9,42.7,36.1,38.0,225,5,True
2025-02-07,BRK,MIA,102,86,57,39,17,23,41.9,35.6,27.0,30.0,188,16,True
2025-02-07,CHO,SAS,117,116,53,38,33,25,46.5,45.7,44.7,30.8,233,1,True
2025-02-07,CLE,WAS,134,124,46,40,32,25,51.1,48.9,42.1,36.4,258,10,True
2025-02-07,DET,PHI,125,112,56,38,32,26,45.4,49.4,38.6,41.9,237,13,True
2025-02-07,MIA,BRK,86,102,39,57,23,17,35.6,41.9,30.0,27.0,188,-16,False
2025-02-07,MIL,ATL,110,115,43,52,28,29,42.7,48.9,38.0,36.1,225,-5,False
2025-02-07,OKC,TOR,121,109,44,42,26,31,51.2,42.9,29.0,46.3,230,12,True
2025-02-07,PHI,DET,112,125,38,56,26,32,49.4,45.4,41.9,38.6,237,-13,False
2025-02-07,PHO,UTA,135,127,49,63,31,29,45.2,41.0,39.3,27.1,262,8,True
2025-02-07,SAS,CHO,116,117,38,53,25,33,45.7,46.5,30.8,44.7,233,-1,False
2025-02-07,TOR,OKC,109,121,42,44,31,26,42.9,51.2,46.3,29.0,230,-12,False
2025-02-07,UTA,PHO,127,135,63,49,29,31,41.0,45.2,27.1,39.3,262,-8,False
2025-02-07,WAS,CLE,124,134,40,46,25,32,48.9,51.1,36.4,42.1,258,-10,False
2024-12-23,ATL,MIN,117,104,38,43,27,31,53.4,42.9,50.0,32.6,221,13,True
2024-12-23,BOS,ORL,104,108,41,42,13,26,44.0,44.6,24.2,39.4,212,-4,False
2024-12-23,BRK,MIA,95,110,42,44,23,27,39.3,49.3,38.2,41.5,205,-15,False
2024-12-23,CHI,MIL,91,112,46,49,27,24,40.0,46.0,20.8,41.9,203,-21,False
2024-12-23,CHO,HOU,101,114,44,60,25,23,41.6,43.4,27.8,31.0,215,-13,False
2024-12-23,CLE,UTA,124,113,40,51,33,27,47.3,41.3,43.5,43.2,237,11,True
2024-12-23,DAL,POR,132,108,41,48,27,23,53.3,46.2,33.3,27.6,240,24,True
2024-12-23,DEN,PHO,117,90,46,39,35,23,51.1,39.8,39.0,39.4,207,27,True
2024-12-23,DET,LAL,117,114,37,38,24,28,51.1,54.1,36.7,46.7,231,3,True
2024-12-23,GSW,IND,105,111,44,43,29,26,43.3,48.9,31.6,31.4,216,-6,False
2024-12-23,HOU,CHO,114,101,60,44,23,25,43.4,41.6,31.0,27.8,215,13,True
2024-12-23,IND,GSW,111,105,43,44,26,29,48.9,43.3,31.4,31.6,216,6,True
2024-12-23,LAC,MEM,114,110,53,56,22,26,43.8,38.4,33.3,38.1,224,4,True
2024-12-23,LAL,DET,114,117,38,37,28,24,54.1,51.1,46.7,36.7,231,-3,False
2024-12-23,MEM,LAC,110,114,56,53,26,22,38.4,43.8,38.1,33.3,224,-4,False
2024-12-23,MIA,BRK,110,95,44,42,27,23,49.3,39.3,41.5,38.2,205,15,True
2024-12-23,MIL,CHI,112,91,49,46,24,27,46.0,40.0,41.9,20.8,203,21,True
2024-12-23,MIN,ATL,104,117,43,38,31,27,42.9,53.4,32.6,50.0,221,-13,False
2024-12-23,NYK,TOR,139,125,35,30,34,28,59.3,54.5,45.9,39.3,264,14,True
2024-12-23,OKC,WAS,123,105,59,51,25,25,44.3,39.6,26.3,37.2,228,18,True
2024-12-23,ORL,BOS,108,104,42,41,26,13,44.6,44.0,39.4,24.2,212,4,True
2024-12-23,PHI,SAS,111,106,47,42,22,24,41.9,45.7,36.4,33.3,217,5,True
2024-12-23,PHO,DEN,90,117,39,46,23,35,39.8,51.1,39.4,39.0,207,-27,False
2024-12-23,POR,DAL,108,132,48,41,23,27,46.2,53.3,27.6,33.3,240,-24,False
2024-12-23,SAS,PHI,106,111,42,47,24,22,45.7,41.9,33.3,36.4,217,-5,False
2024-12-23,TOR,NYK,125,139,30,35,28,34,54.5,59.3,39.3,45.9,264,-14,False
2024-12-23,UTA,CLE,113,124,51,40,27,33,41.3,47.3,43.2,43.5,237,-11,False
2024-12-23,WAS,OKC,105,123,51,59,25,25,39.6,44.3,37.2,26.3,228,-18,False
2025-01-27,ATL,MIN,92,100,51,51,24,18,39.5,39.5,27.9,30.0,192,-8,False
2025-01-27,BOS,HOU,112,114,41,39,21,29,48.8,44.6,38.5,41.5,226,-2,False
2025-01-27,BRK,SAC,96,110,39,44,19,31,36.6,54.9,27.8,32.1,206,-14,False
2025-01-27,CHI,DEN,129,121,47,42,35,36,50.0,52.0,45.3,22.2,250,8,True
2025-01-27,CHO,LAL,107,112,34,48,26,22,44.8,51.2,38.9,21.4,219,-5,False
2025-01-27,CLE,DET,110,91,53,45,28,24,44.0,38.5,27.3,27.8,201,19,True
2025-01-27,DAL,WAS,130,108,51,45,39,23,53.3,41.6,44.4,29.7,238,22,True
2025-01-27,DEN,CHI,121,129,42,47,36,35,52.0,50.0,22.2,45.3,250,-8,False
2025-01-27,DET,CLE,91,110,45,53,24,28,38.5,44.0,27.8,27.3,201,-19,False
2025-01-27,HOU,BOS,114,112,39,41,29,21,44.6,48.8,41.5,38.5,226,2,True
2025-01-27,LAC,PHO,109,111,42,39,22,23,49.4,47.1,31.2,46.8,220,-2,False
2025-01-27,LAL,CHO,112,107,48,34,22,26,51.2,44.8,21.4,38.9,219,5,True
2025-01-27,MEM,NYK,106,143,47,46,21,32,45.1,51.9,37.5,38.6,249,-37,False
2025-01-27,MIA,ORL,125,119,43,47,34,32,52.2,45.9,36.6,35.9,244,6,True
2025-01-27,MIL,UTA,125,110,46,46,33,28,60.5,41.0,35.3,33.3,235,15,True
2025-01-27,MIN,ATL,100,92,51,51,18,24,39.5,39.5,30.0,27.9,192,8,True
2025-01-27,NOP,TOR,104,113,46,54,21,31,43.8,43.0,21.4,27.3,217,-9,False
2025-01-27,NYK,MEM,143,106,46,47,32,21,51.9,45.1,38.6,37.5,249,37,True
2025-01-27,ORL,MIA,119,125,47,43,32,34,45.9,52.2,35.9,36.6,244,-6,False
2025-01-27,PHO,LAC,111,109,39,42,23,22,47.1,49.4,46.8,31.2,220,2,True
2025-01-27,SAC,BRK,110,96,44,39,31,19,54.9,36.6,32.1,27.8,206,14,True
2025-01-27,TOR,NOP,113,104,54,46,31,21,43.0,43.8,27.3,21.4,217,9,True
2025-01-27,UTA,MIL,110,125,46,46,28,33,41.0,60.5,33.3,35.3,235,-15,False
2025-01-27,WAS,DAL,108,130,45,51,23,39,41.6,53.3,29.7,44.4,238,-22,False
2024-11-03,ATL,NOP,126,111,41,43,29,22,56.8,43.3,41.7,42.1,237,15,True
2024-11-03,BRK,DET,92,106,27,47,23,25,45.1,48.1,29.0,30.6,198,-14,False
2024-11-03,DAL,ORL,108,85,53,43,25,19,49.4,33.3,31.2,19.5,193,23,True
2024-11-03,DET,BRK,106,92,47,27,25,23,48.1,45.1,30.6,29.0,198,14,True
2024-11-03,NOP,ATL,111,126,43,41,22,29,43.3,56.8,42.1,41.7,237,-15,False
2024-11-03,ORL,DAL,85,108,43,53,19,25,33.3,49.4,19.5,31.2,193,-23,False
2024-12-02,ATL,NOP,124,112,51,41,30,21,51.0,44.0,26.3,31.0,236,12,True
2024-12-02,BOS,MIA,108,89,54,44,25,24,43.8,35.6,34.5,22.9,197,19,True
2024-12-02,BRK,CHI,102,128,41,54,24,33,40.0,52.2,33.3,34.0,230,-26,False
2024-12-02,CHI,BRK,128,102,54,41,33,24,52.2,40.0,34.0,33.3,230,26,True
2024-12-02,LAL,MIN,80,109,39,43,19,31,40.5,50.6,19.4,42.9,189,-29,False
2024-12-02,MIA,BOS,89,108,44,54,24,25,35.6,43.8,22.9,34.5,197,-19,False
2024-12-02,MIN,LAL,109,80,43,39,31,19,50.6,40.5,42.9,19.4,189,29,True
2024-12-02,NOP,ATL,112,124,41,51,21,30,44.0,51.0,31.0,26.3,236,-12,False
2024-11-06,ATL,NYK,121,116,48,41,31,29,45.0,48.8,39.5,46.8,237,5,True
2024-11-06,BOS,GSW,112,118,47,53,22,22,42.2,46.2,35.2,41.2,230,-6,False
2024-11-06,CHI,DAL,99,119,51,47,25,33,41.9,48.4,28.6,31.6,218,-20,False
2024-11-06,CHO,DET,108,107,47,46,22,34,43.3,48.9,31.8,31.2,215,1,True
2024-11-06,CLE,NOP,131,122,46,33,33,21,54.2,47.7,48.6,48.1,253,9,True
2024-11-06,DAL,CHI,119,99,47,51,33,25,48.4,41.9,31.6,28.6,218,20,True
2024-11-06,DEN,OKC,124,122,55,47,34,29,47.2,44.0,42.1,40.0,246,2,True
2024-11-06,DET,CHO,107,108,46,47,34,22,48.9,43.3,31.2,31.8,215,-1,False
2024-11-06,GSW,BOS,118,112,53,47,22,22,46.2,42.2,41.2,35.2,230,6,True
2024-11-06,HOU,SAS,127,100,45,41,28,20,56.2,44.6,37.0,38.9,227,27,True
2024-11-06,IND,ORL,118,111,36,38,21,26,53.9,51.2,46.2,28.0,229,7,True
2024-11-06,LAC,PHI,110,98,29,32,27,19,56.9,54.8,42.9,28.0,208,12,True
2024-11-06,LAL,MEM,114,131,37,50,23,28,44.1,51.6,31.2,50.0,245,-17,False
2024-11-06,MEM,LAL,131,114,50,37,28,23,51.6,44.1,50.0,31.2,245,17,True
2024-11-06,MIA,PHO,112,115,43,46,27,29,43.5,50.0,38.2,41.9,227,-3,False
2024-11-06,NOP,CLE,122,131,33,46,21,33,47.7,54.2,48.1,48.6,253,-9,False
2024-11-06,NYK,ATL,116,121,41,48,29,31,48.8,45.0,46.8,39.5,237,-5,False
2024-11-06,OKC,DEN,122,124,47,55,29,34,44.0,47.2,40.0,42.1,246,-2,False
2024-11-06,ORL,IND,111,118,38,36,26,21,51.2,53.9,28.0,46.2,229,-7,False
2024-11-06,PHI,LAC,98,110,32,29,19,27,54.8,56.9,28.0,42.9,208,-12,False
2024-11-06,PHO,MIA,115,112,46,43,29,27,50.0,43.5,41.9,38.2,227,3,True
2024-11-06,SAC,TOR,122,107,47,34,26,25,46.7,48.9,28.6,29.4,229,15,True
2024-11-06,SAS,HOU,100,127,41,45,20,28,44.6,56.2,38.9,37.0,227,-27,False
2024-11-06,TOR,SAC,107,122,34,47,25,26,48.9,46.7,29.4,28.6,229,-15,False
2024-12-11,ATL,NYK,108,100,58,49,27,27,41.3,43.0,29.0,26.2,208,8,True
2024-12-11,GSW,HOU,90,91,39,36,22,23,44.0,45.8,31.6,22.2,181,-1,False
2024-12-11,HOU,GSW,91,90,36,39,23,22,45.8,44.0,22.2,31.6,181,1,True
2024-12-11,NYK,ATL,100,108,49,58,27,27,43.0,41.3,26.2,29.0,208,-8,False
2025-01-20,ATL,NYK,110,119,41,39,23,31,47.1,52.2,43.3,34.6,229,-9,False
2025-01-20,BOS,GSW,125,85,50,38,33,28,53.3,34.8,41.7,26.4,210,40,True
2025-01-20,CHI,LAC,112,99,54,40,25,24,40.4,39.4,32.6,21.4,211,13,True
2025-01-20,CHO,DAL,110,105,49,51,28,19,40.8,43.2,43.6,18.8,215,5,True
2025-01-20,CLE,PHO,118,92,50,34,27,22,43.2,46.8,41.3,38.5,210,26,True
2025-01-20,DAL,CHO,105,110,51,49,19,28,43.2,40.8,18.8,43.6,215,-5,False
2025-01-20,DET,HOU,107,96,52,39,21,19,47.7,39.4,37.0,28.2,203,11,True
2025-01-20,GSW,BOS,85,125,38,50,28,33,34.8,53.3,26.4,41.7,210,-40,False
2025-01-20,HOU,DET,96,107,39,52,19,21,39.4,47.7,28.2,37.0,203,-11,False
2025-01-20,LAC,CHI,99,112,40,54,24,25,39.4,40.4,21.4,32.6,211,-13,False
2025-01-20,MEM,MIN,108,106,47,52,19,25,43.0,38.7,21.2,32.6,214,2,True
2025-01-20,MIN,MEM,106,108,52,47,25,19,38.7,43.0,32.6,21.2,214,-2,False
2025-01-20,NOP,UTA,123,119,45,63,28,25,44.6,39.6,36.6,23.9,242,4,True
2025-01-20,NYK,ATL,119,110,39,41,31,23,52.2,47.1,34.6,43.3,229,9,True
2025-01-20,PHO,CLE,92,118,34,50,22,27,46.8,43.2,38.5,41.3,210,-26,False
2025-01-20,UTA,NOP,119,123,63,45,25,28,39.6,44.6,23.9,36.6,242,-4,False
2024-10-27,ATL,OKC,104,128,49,45,24,26,39.6,49.4,32.3,40.0,232,-24,False
2024-10-27,BRK,MIL,115,102,47,43,23,20,42.9,44.6,35.6,30.3,217,13,True
2024-10-27,GSW,LAC,104,112,47,48,19,27,43.2,46.7,32.6,31.2,216,-8,False
2024-10-27,IND,PHI,114,118,37,54,28,15,46.4,42.9,40.6,26.2,232,-4,False
2024-10-27,LAC,GSW,112,104,48,47,27,19,46.7,43.2,31.2,32.6,216,8,True
2024-10-27,MIL,BRK,102,115,43,47,20,23,44.6,42.9,30.3,35.6,217,-13,False
2024-10-27,NOP,POR,103,125,39,51,24,25,43.2,46.2,27.6,40.0,228,-22,False
2024-10-27,OKC,ATL,128,104,45,49,26,24,49.4,39.6,40.0,32.3,232,24,True
2024-10-27,PHI,IND,118,114,54,37,15,28,42.9,46.4,26.2,40.6,232,4,True
2024-10-27,POR,NOP,125,103,51,39,25,24,46.2,43.2,40.0,27.6,228,22,True
2025-01-09,ATL,PHO,115,123,32,42,32,33,48.8,57.6,46.9,39.4,238,-8,False
2025-01-09,CLE,TOR,132,126,42,37,31,34,52.8,59.6,40.0,45.2,258,6,True
2025-01-09,DAL,POR,117,111,53,43,26,24,45.5,41.9,33.3,44.4,228,6,True
2025-01-09,DET,GSW,104,107,40,49,25,32,45.3,46.1,35.9,32.6,211,-3,False
2025-01-09,GSW,DET,107,104,49,40,32,25,46.1,45.3,32.6,35.9,211,3,True
2025-01-09,HOU,MEM,119,115,44,43,21,20,42.7,50.0,38.2,31.2,234,4,True
2025-01-09,MEM,HOU,115,119,43,44,20,21,50.0,42.7,31.2,38.2,234,-4,False
2025-01-09,MIA,UTA,97,92,49,49,26,20,39.6,39.8,28.0,30.6,189,5,True
2025-01-09,MIN,ORL,104,89,50,47,21,21,40.0,37.9,35.3,25.0,193,15,True
2025-01-09,ORL,MIN,89,104,47,50,21,21,37.9,40.0,25.0,35.3,193,-15,False
2025-01-09,PHO,ATL,123,115,42,32,33,32,57.6,48.8,39.4,46.9,238,8,True
2025-01-09,POR,DAL,111,117,43,53,24,26,41.9,45.5,44.4,33.3,228,-6,False
2025-01-09,TOR,CLE,126,132,37,42,34,31,59.6,52.8,45.2,40.0,258,-6,False
2025-01-09,UTA,MIA,92,97,49,49,20,26,39.8,39.6,30.6,28.0,189,-5,False
2025-01-14,ATL,PHO,122,117,54,37,22,28,43.9,51.2,41.5,37.1,239,5,True
2025-01-14,BRK,POR,132,114,44,38,36,20,54.4,45.3,46.3,44.7,246,18,True
2025-01-14,CHI,NOP,113,119,57,46,31,32,44.1,43.8,32.6,28.0,232,-6,False
2025-01-14,CLE,IND,127,117,49,37,25,30,48.3,48.4,34.1,42.9,244,10,True
2025-01-14,DAL,DEN,99,118,30,51,27,28,42.2,51.8,28.1,44.8,217,-19,False
2025-01-14,DEN,DAL,118,99,51,30,28,27,51.8,42.2,44.8,28.1,217,19,True
2025-01-14,IND,CLE,117,127,37,49,30,25,48.4,48.3,42.9,34.1,244,-10,False
2025-01-14,MIL,SAC,130,115,52,45,32,25,49.5,44.2,37.8,40.5,245,15,True
2025-01-14,NOP,CHI,119,113,46,57,32,31,43.8,44.1,28.0,32.6,232,6,True
2025-01-14,OKC,PHI,118,102,38,35,32,23,55.6,44.0,33.3,29.5,220,16,True
2025-01-14,PHI,OKC,102,118,35,38,23,32,44.0,55.6,29.5,33.3,220,-16,False
2025-01-14,PHO,ATL,117,122,37,54,28,22,51.2,43.9,37.1,41.5,239,-5,False
2025-01-14,POR,BRK,114,132,38,44,20,36,45.3,54.4,44.7,46.3,246,-18,False
2025-01-14,SAC,MIL,115,130,45,52,25,32,44.2,49.5,40.5,37.8,245,-15,False
2024-11-17,ATL,POR,110,114,47,40,30,31,45.9,46.3,34.4,36.8,224,-4,False
2024-11-17,BRK,NYK,104,114,35,47,31,33,42.1,48.9,41.5,32.5,218,-10,False
2024-11-17,CHI,HOU,107,143,47,66,26,34,33.6,52.4,25.0,29.4,250,-36,False
2024-11-17,CHO,CLE,114,128,40,48,34,26,40.8,57.1,38.5,43.3,242,-14,False
2024-11-17,CLE,CHO,128,114,48,40,26,34,57.1,40.8,43.3,38.5,242,14,True
2024-11-17,DAL,OKC,121,119,53,29,18,29,47.6,49.4,40.7,33.3,240,2,True
2024-11-17,DEN,MEM,90,105,39,45,23,31,41.7,45.1,32.3,33.3,195,-15,False
2024-11-17,DET,WAS,124,104,51,39,27,21,47.4,47.0,44.7,44.4,228,20,True
2024-11-17,HOU,CHI,143,107,66,47,34,26,52.4,33.6,29.4,25.0,250,36,True
2024-11-17,IND,MIA,119,110,45,38,30,21,51.8,40.0,44.8,44.2,229,9,True
2024-11-17,LAC,UTA,116,105,41,41,30,24,48.9,49.4,27.5,30.0,221,11,True
2024-11-17,MEM,DEN,105,90,45,39,31,23,45.1,41.7,33.3,32.3,195,15,True
2024-11-17,MIA,IND,110,119,38,45,21,30,40.0,51.8,44.2,44.8,229,-9,False
2024-11-17,MIN,PHO,120,117,32,41,27,29,52.5,54.1,43.6,45.2,237,3,True
2024-11-17,NYK,BRK,114,104,47,35,33,31,48.9,42.1,32.5,41.5,218,10,True
2024-11-17,OKC,DAL,119,121,29,53,29,18,49.4,47.6,33.3,40.7,240,-2,False
2024-11-17,PHO,MIN,117,120,41,32,29,27,54.1,52.5,45.2,43.6,237,-3,False
2024-11-17,POR,ATL,114,110,40,47,31,30,46.3,45.9,36.8,34.4,224,4,True
2024-11-17,UTA,LAC,105,116,41,41,24,30,49.4,48.9,30.0,27.5,221,-11,False
2024-11-17,WAS,DET,104,124,39,51,21,27,47.0,47.4,44.4,44.7,228,-20,False
2024-11-01,ATL,SAC,115,123,40,51,30,28,44.6,48.3,38.0,33.3,238,-8,False
2024-11-01,BOS,CHO,124,109,41,42,21,20,47.7,46.2,31.0,39.6,233,15,True
2024-11-01,BRK,CHI,120,112,46,44,34,24,52.1,43.2,30.6,38.6,232,8,True
2024-11-01,CHI,BRK,112,120,44,46,24,34,43.2,52.1,38.6,30.6,232,-8,False
2024-11-01,CHO,BOS,109,124,42,41,20,21,46.2,47.7,39.6,31.0,233,-15,False
2024-11-01,CLE,ORL,120,109,49,39,25,26,50.6,45.6,39.5,33.3,229,11,True
2024-11-01,DEN,MIN,116,119,46,38,30,34,44.6,51.8,34.4,42.9,235,-3,False
2024-11-01,DET,NYK,98,128,38,45,23,31,50.6,51.5,32.4,47.4,226,-30,False
2024-11-01,IND,NOP,118,125,39,46,35,28,51.7,48.5,42.1,38.7,243,-7,False
2024-11-01,LAL,TOR,131,125,43,44,29,35,47.7,48.6,34.4,28.6,256,6,True
2024-11-01,MIN,DEN,119,116,38,46,34,30,51.8,44.6,42.9,34.4,235,3,True
2024-11-01,NOP,IND,125,118,46,39,28,35,48.5,51.7,38.7,42.1,243,7,True
2024-11-01,NYK,DET,128,98,45,38,31,23,51.5,50.6,47.4,32.4,226,30,True
2024-11-01,OKC,POR,137,114,45,36,31,27,53.7,47.0,38.8,42.9,251,23,True
2024-11-01,ORL,CLE,109,120,39,49,26,25,45.6,50.6,33.3,39.5,229,-11,False
2024-11-01,POR,OKC,114,137,36,45,27,31,47.0,53.7,42.9,38.8,251,-23,False
2024-11-01,SAC,ATL,123,115,51,40,28,30,48.3,44.6,33.3,38.0,238,8,True
2024-11-01,TOR,LAL,125,131,44,43,35,29,48.6,47.7,28.6,34.4,256,-6,False
2024-11-18,ATL,SAC,109,108,37,45,34,24,47.0,43.5,42.1,43.5,217,1,True
2024-11-18,CHI,DET,122,112,46,48,28,27,48.4,42.9,50.0,34.1,234,10,True
2024-11-18,DET,CHI,112,122,48,46,27,28,42.9,48.4,34.1,50.0,234,-10,False
2024-11-18,GSW,LAC,99,102,45,44,27,29,44.0,42.7,36.4,47.1,201,-3,False
2024-11-18,HOU,MIL,100,101,53,43,19,21,40.0,45.8,28.1,39.4,201,-1,False
2024-11-18,IND,TOR,119,130,32,46,29,27,44.4,58.5,37.5,48.3,249,-11,False
2024-11-18,LAC,GSW,102,99,44,45,29,27,42.7,44.0,47.1,36.4,201,3,True
2024-11-18,MIA,PHI,106,89,53,42,26,25,41.4,41.7,29.5,24.4,195,17,True
2024-11-18,MIL,HOU,101,100,43,53,21,19,45.8,40.0,39.4,28.1,201,1,True
2024-11-18,NYK,WAS,134,106,41,41,37,23,56.0,47.3,50.0,33.3,240,28,True
2024-11-18,ORL,PHO,109,99,38,45,28,25,51.3,42.2,37.9,29.3,208,10,True
2024-11-18,PHI,MIA,89,106,42,53,25,26,41.7,41.4,24.4,29.5,195,-17,False
2024-11-18,PHO,ORL,99,109,45,38,25,28,42.2,51.3,29.3,37.9,208,-10,False
2024-11-18,SAC,ATL,108,109,45,37,24,34,43.5,47.0,43.5,42.1,217,-1,False
2024-11-18,TOR,IND,130,119,46,32,27,29,58.5,44.4,48.3,37.5,249,11,True
2024-11-18,WAS,NYK,106,134,41,41,23,37,47.3,56.0,33.3,50.0,240,-28,False
2024-12-19,ATL,SAS,126,133,53,42,32,32,47.4,48.5,42.1,45.2,259,-7,False
2024-12-19,BOS,CHI,108,117,45,56,21,23,39.2,44.7,25.0,36.5,225,-9,False
2024-12-19,BRK,TOR,101,94,53,34,18,26,40.2,39.5,23.1,34.1,195,7,True
2024-12-19,CHI,BOS,117,108,56,45,23,21,44.7,39.2,36.5,25.0,225,9,True
2024-12-19,CHO,WAS,114,123,52,52,30,33,40.6,49.4,18.6,40.5,237,-9,False
2024-12-19,DAL,LAC,95,118,40,47,21,30,39.5,51.8,23.3,42.4,213,-23,False
2024-12-19,DEN,POR,124,126,40,45,35,29,54.0,46.4,44.1,34.8,250,-2,False
2024-12-19,DET,UTA,119,126,39,62,26,23,43.8,47.0,27.7,50.0,245,-7,False
2024-12-19,GSW,MEM,93,144,36,60,20,38,35.6,54.1,33.3,56.2,237,-51,False
2024-12-19,HOU,NOP,133,113,42,37,34,25,57.5,44.6,43.6,46.4,246,20,True
2024-12-19,IND,PHO,120,111,47,44,30,28,43.8,48.8,39.0,30.0,231,9,True
2024-12-19,LAC,DAL,118,95,47,40,30,21,51.8,39.5,42.4,23.3,213,23,True
2024-12-19,LAL,SAC,113,100,52,43,22,27,40.9,45.1,36.4,37.9,213,13,True
2024-12-19,MEM,GSW,144,93,60,36,38,20,54.1,35.6,56.2,33.3,237,51,True
2024-12-19,MIN,NYK,107,133,37,57,29,39,46.1,51.5,40.5,44.4,240,-26,False
2024-12-19,NOP,HOU,113,133,37,42,25,34,44.6,57.5,46.4,43.6,246,-20,False
2024-12-19,NYK,MIN,133,107,57,37,39,29,51.5,46.1,44.4,40.5,240,26,True
2024-12-19,OKC,ORL,105,99,32,40,23,25,48.2,44.9,32.3,31.4,204,6,True
2024-12-19,ORL,OKC,99,105,40,32,25,23,44.9,48.2,31.4,32.3,204,-6,False
2024-12-19,PHO,IND,111,120,44,47,28,30,48.8,43.8,30.0,39.0,231,-9,False
2024-12-19,POR,DEN,126,124,45,40,29,35,46.4,54.0,34.8,44.1,250,2,True
2024-12-19,SAC,LAL,100,113,43,52,27,22,45.1,40.9,37.9,36.4,213,-13,False
2024-12-19,SAS,ATL,133,126,42,53,32,32,48.5,47.4,45.2,42.1,259,7,True
2024-12-19,TOR,BRK,94,101,34,53,26,18,39.5,40.2,34.1,23.1,195,-7,False
2024-12-19,UTA,DET,126,119,62,39,23,26,47.0,43.8,50.0,27.7,245,7,True
2024-12-19,WAS,CHO,123,114,52,52,33,30,49.4,40.6,40.5,18.6,237,9,True
2025-02-05,ATL,SAS,125,126,45,41,33,36,52.7,50.5,38.1,32.4,251,-1,False
2025-02-05,BRK,WAS,102,119,37,40,26,40,43.4,54.3,34.2,46.5,221,-17,False
2025-02-05,CHI,MIN,108,127,34,59,25,27,48.2,42.9,33.3,42.6,235,-19,False
2025-02-05,CHO,MIL,102,112,41,44,21,26,43.2,50.6,32.4,42.9,214,-10,False
2025-02-05,CLE,DET,118,115,46,45,28,22,48.2,39.8,42.1,32.4,233,3,True
2025-02-05,DEN,NOP,144,119,51,38,40,26,57.0,46.2,37.2,34.5,263,25,True
2025-02-05,DET,CLE,115,118,45,46,22,28,39.8,48.2,32.4,42.1,233,-3,False
2025-02-05,GSW,UTA,128,131,41,48,33,30,46.0,52.2,35.4,35.1,259,-3,False
2025-02-05,MEM,TOR,138,107,61,34,22,28,52.8,39.8,42.1,28.6,245,31,True
2025-02-05,MIA,PHI,108,101,54,39,25,22,47.0,38.5,41.2,30.0,209,7,True
2025-02-05,MIL,CHO,112,102,44,41,26,21,50.6,43.2,42.9,32.4,214,10,True
2025-02-05,MIN,CHI,127,108,59,34,27,25,42.9,48.2,42.6,33.3,235,19,True
2025-02-05,NOP,DEN,119,144,38,51,26,40,46.2,57.0,34.5,37.2,263,-25,False
2025-02-05,OKC,PHO,140,109,46,35,24,24,51.0,47.1,28.6,38.9,249,31,True
2025-02-05,ORL,SAC,130,111,35,37,30,23,56.8,50.0,51.6,37.0,241,19,True
2025-02-05,PHI,MIA,101,108,39,54,22,25,38.5,47.0,30.0,41.2,209,-7,False
2025-02-05,PHO,OKC,109,140,35,46,24,24,47.1,51.0,38.9,28.6,249,-31,False
2025-02-05,SAC,ORL,111,130,37,35,23,30,50.0,56.8,37.0,51.6,241,-19,False
2025-02-05,SAS,ATL,126,125,41,45,36,33,50.5,52.7,32.4,38.1,251,1,True
2025-02-05,TOR,MEM,107,138,34,61,28,22,39.8,52.8,28.6,42.1,245,-31,False
2025-02-05,UTA,GSW,131,128,48,41,30,33,52.2,46.0,35.1,35.4,259,3,True
2025-02-05,WAS,BRK,119,102,40,37,40,26,54.3,43.4,46.5,34.2,221,17,True
2024-12-29,ATL,TOR,136,107,40,52,30,26,48.4,44.7,40.0,29.2,243,29,True
2024-12-29,BOS,IND,114,123,41,50,26,27,46.2,52.9,29.6,39.1,237,-9,False
2024-12-29,BRK,ORL,101,102,38,42,22,30,43.8,44.6,43.3,33.3,203,-1,False
2024-12-29,HOU,MIA,100,104,52,52,24,21,39.2,44.0,32.5,30.3,204,-4,False
2024-12-29,IND,BOS,123,114,50,41,27,26,52.9,46.2,39.1,29.6,237,9,True
2024-12-29,MEM,OKC,106,130,51,45,30,35,38.1,50.5,27.5,31.8,236,-24,False
2024-12-29,MIA,HOU,104,100,52,52,21,24,44.0,39.2,30.3,32.5,204,4,True
2024-12-29,MIN,SAS,112,110,56,41,23,25,43.0,43.7,25.0,28.2,222,2,True
2024-12-29,OKC,MEM,130,106,45,51,35,30,50.5,38.1,31.8,27.5,236,24,True
2024-12-29,ORL,BRK,102,101,42,38,30,22,44.6,43.8,33.3,43.3,203,1,True
2024-12-29,SAS,MIN,110,112,41,56,25,23,43.7,43.0,28.2,25.0,222,-2,False
2024-12-29,TOR,ATL,107,136,52,40,26,30,44.7,48.4,29.2,40.0,243,-29,False
2025-01-23,ATL,TOR,119,122,36,39,30,32,48.3,58.0,35.1,42.9,241,-3,False
2025-01-23,BOS,LAL,96,117,42,53,23,27,38.5,47.2,34.1,42.9,213,-21,False
2025-01-23,CHI,GSW,106,131,42,52,22,37,39.1,45.1,40.0,43.9,237,-25,False
2025-01-23,DAL,OKC,121,115,43,33,25,26,52.7,47.7,45.2,40.5,236,6,True
2025-01-23,DEN,SAC,132,123,56,53,30,31,48.5,43.9,35.1,36.6,255,9,True
2025-01-23,GSW,CHI,131,106,52,42,37,22,45.1,39.1,43.9,40.0,237,25,True
2025-01-23,IND,SAS,110,140,31,57,31,43,45.4,60.4,30.2,50.0,250,-30,False
2025-01-23,LAC,WAS,110,93,55,49,29,24,45.5,34.0,34.2,23.9,203,17,True
2025-01-23,LAL,BOS,117,96,53,42,27,23,47.2,38.5,42.9,34.1,213,21,True
2025-01-23,MIA,MIL,96,125,50,55,26,32,37.0,46.9,23.5,45.0,221,-29,False
2025-01-23,MIL,MIA,125,96,55,50,32,26,46.9,37.0,45.0,23.5,221,29,True
2025-01-23,OKC,DAL,115,121,33,43,26,25,47.7,52.7,40.5,45.2,236,-6,False
2025-01-23,ORL,POR,79,101,44,42,17,23,34.2,48.8,24.0,32.1,180,-22,False
2025-01-23,POR,ORL,101,79,42,44,23,17,48.8,34.2,32.1,24.0,180,22,True
2025-01-23,SAC,DEN,123,132,53,56,31,30,43.9,48.5,36.6,35.1,255,-9,False
2025-01-23,SAS,IND,140,110,57,31,43,31,60.4,45.4,50.0,30.2,250,30,True
2025-01-23,TOR,ATL,122,119,39,36,32,30,58.0,48.3,42.9,35.1,241,3,True
2025-01-23,WAS,LAC,93,110,49,55,24,29,34.0,45.5,23.9,34.2,203,-17,False
2025-01-25,ATL,TOR,94,117,43,51,28,31,39.3,46.7,29.7,36.7,211,-23,False
2025-01-25,BOS,DAL,122,107,51,49,33,18,42.7,44.3,38.5,36.4,229,15,True
2025-01-25,BRK,MIA,97,106,35,51,23,22,37.5,44.3,35.0,46.4,203,-9,False
2025-01-25,CHI,PHI,97,109,54,40,24,23,42.4,45.7,31.6,28.9,206,-12,False
2025-01-25,CHO,NOP,123,92,48,39,28,21,50.0,38.1,42.0,25.8,215,31,True
2025-01-25,CLE,HOU,131,135,40,45,28,26,51.6,54.9,43.6,46.4,266,-4,False
2025-01-25,DAL,BOS,107,122,49,51,18,33,44.3,42.7,36.4,38.5,229,-15,False
2025-01-25,DEN,MIN,104,133,36,45,32,38,48.9,55.8,34.4,46.7,237,-29,False
2025-01-25,DET,ORL,113,121,41,40,22,22,46.5,48.2,40.0,45.5,234,-8,False
2025-01-25,GSW,LAL,108,118,38,42,30,29,46.1,54.7,34.8,34.5,226,-10,False
2025-01-25,HOU,CLE,135,131,45,40,26,28,54.9,51.6,46.4,43.6,266,4,True
2025-01-25,IND,SAS,136,98,50,44,32,22,52.0,41.2,43.6,34.4,234,38,True
2025-01-25,LAC,MIL,127,117,47,42,19,24,45.4,46.8,32.4,37.1,244,10,True
2025-01-25,LAL,GSW,118,108,42,38,29,30,54.7,46.1,34.5,34.8,226,10,True
2025-01-25,MEM,UTA,125,103,45,40,28,27,51.2,42.4,36.8,25.5,228,22,True
2025-01-25,MIA,BRK,106,97,51,35,22,23,44.3,37.5,46.4,35.0,203,9,True
2025-01-25,MIL,LAC,117,127,42,47,24,19,46.8,45.4,37.1,32.4,244,-10,False
2025-01-25,MIN,DEN,133,104,45,36,38,32,55.8,48.9,46.7,34.4,237,29,True
2025-01-25,NOP,CHO,92,123,39,48,21,28,38.1,50.0,25.8,42.0,215,-31,False
2025-01-25,NYK,SAC,143,120,53,38,40,33,49.5,48.4,47.2,38.9,263,23,True
2025-01-25,ORL,DET,121,113,40,41,22,22,48.2,46.5,45.5,40.0,234,8,True
2025-01-25,PHI,CHI,109,97,40,54,23,24,45.7,42.4,28.9,31.6,206,12,True
2025-01-25,PHO,WAS,119,109,53,37,24,28,44.4,46.7,32.5,43.9,228,10,True
2025-01-25,SAC,NYK,120,143,38,53,33,40,48.4,49.5,38.9,47.2,263,-23,False
2025-01-25,SAS,IND,98,136,44,50,22,32,41.2,52.0,34.4,43.6,234,-38,False
2025-01-25,TOR,ATL,117,94,51,43,31,28,46.7,39.3,36.7,29.7,211,23,True
2025-01-25,UTA,MEM,103,125,40,45,27,28,42.4,51.2,25.5,36.8,228,-22,False
2025-01-25,WAS,PHO,109,119,37,53,28,24,46.7,44.4,43.9,32.5,228,-10,False
2025-01-07,ATL,UTA,124,121,44,47,35,25,48.0,41.7,40.9,39.6,245,3,True
2025-01-07,BOS,DEN,118,106,41,39,30,22,50.0,46.0,34.3,38.9,224,12,True
2025-01-07,CHO,PHO,115,104,59,42,23,27,38.8,42.4,27.7,24.2,219,11,True
2025-01-07,DAL,LAL,118,97,44,33,29,20,52.3,45.3,47.4,31.4,215,21,True
2025-01-07,DEN,BOS,106,118,39,41,22,30,46.0,50.0,38.9,34.3,224,-12,False
2025-01-07,GSW,MIA,98,114,52,48,28,32,40.8,47.3,28.0,40.0,212,-16,False
2025-01-07,HOU,WAS,135,112,49,43,31,21,51.5,46.1,39.5,37.5,247,23,True
2025-01-07,LAL,DAL,97,118,33,44,20,29,45.3,52.3,31.4,47.4,215,-21,False
2025-01-07,MIA,GSW,114,98,48,52,32,28,47.3,40.8,40.0,28.0,212,16,True
2025-01-07,MIN,NOP,104,97,53,46,26,23,42.7,37.2,34.1,29.3,201,7,True
2025-01-07,NOP,MIN,97,104,46,53,23,26,37.2,42.7,29.3,34.1,201,-7,False
2025-01-07,PHO,CHO,104,115,42,59,27,23,42.4,38.8,24.2,27.7,219,-11,False
2025-01-07,UTA,ATL,121,124,47,44,25,35,41.7,48.0,39.6,40.9,245,-3,False
2025-01-07,WAS,HOU,112,135,43,49,21,31,46.1,51.5,37.5,39.5,247,-23,False
2024-10-28,ATL,WAS,119,121,39,43,32,24,48.1,45.1,37.5,47.7,240,-2,False
2024-10-28,BOS,MIL,119,108,38,43,24,18,49.4,45.1,38.3,25.8,227,11,True
2024-10-28,CHI,MEM,126,123,50,60,36,37,45.0,45.9,47.2,32.6,249,3,True
2024-10-28,CLE,NYK,110,104,41,43,21,22,47.6,44.4,33.3,32.1,214,6,True
2024-10-28,DAL,UTA,110,102,50,50,27,24,45.3,37.0,28.2,28.6,212,8,True
2024-10-28,DEN,TOR,127,125,52,54,29,30,49.0,45.0,45.0,28.6,252,2,True
2024-10-28,DET,MIA,98,106,54,44,14,24,38.5,43.2,36.8,31.9,204,-8,False
2024-10-28,HOU,SAS,106,101,43,49,20,22,41.2,42.5,40.5,30.3,207,5,True
2024-10-28,IND,ORL,115,119,44,46,25,26,46.6,47.0,44.8,31.7,234,-4,False
2024-10-28,LAL,PHO,105,109,46,46,25,21,41.5,46.0,43.8,30.6,214,-4,False
2024-10-28,MEM,CHI,123,126,60,50,37,36,45.9,45.0,32.6,47.2,249,-3,False
2024-10-28,MIA,DET,106,98,44,54,24,14,43.2,38.5,31.9,36.8,204,8,True
2024-10-28,MIL,BOS,108,119,43,38,18,24,45.1,49.4,25.8,38.3,227,-11,False
2024-10-28,NYK,CLE,104,110,43,41,22,21,44.4,47.6,32.1,33.3,214,-6,False
2024-10-28,ORL,IND,119,115,46,44,26,25,47.0,46.6,31.7,44.8,234,4,True
2024-10-28,PHO,LAL,109,105,46,46,21,25,46.0,41.5,30.6,43.8,214,4,True
2024-10-28,POR,SAC,98,111,46,40,17,25,42.2,45.7,18.2,40.0,209,-13,False
2024-10-28,SAC,POR,111,98,40,46,25,17,45.7,42.2,40.0,18.2,209,13,True
2024-10-28,SAS,HOU,101,106,49,43,22,20,42.5,41.2,30.3,40.5,207,-5,False
2024-10-28,TOR,DEN,125,127,54,52,30,29,45.0,49.0,28.6,45.0,252,-2,False
2024-10-28,UTA,DAL,102,110,50,50,24,27,37.0,45.3,28.6,28.2,212,-8,False
2024-10-28,WAS,ATL,121,119,43,39,24,32,45.1,48.1,47.7,37.5,240,2,True
2024-10-30,ATL,WAS,120,133,41,37,28,32,47.4,53.4,30.8,42.1,253,-13,False
2024-10-30,BOS,IND,132,135,51,57,23,33,40.4,48.1,33.3,39.5,267,-3,False
2024-10-30,BRK,MEM,119,106,34,38,27,27,51.2,46.9,36.6,29.6,225,13,True
2024-10-30,CHI,ORL,102,99,54,42,23,25,42.9,40.7,38.2,23.9,201,3,True
2024-10-30,CHO,TOR,138,133,38,41,31,37,52.1,57.1,44.4,32.1,271,5,True
2024-10-30,CLE,LAL,134,110,36,37,37,21,57.7,49.4,41.5,21.4,244,24,True
2024-10-30,DET,PHI,105,95,49,37,23,17,46.2,41.8,41.7,28.6,200,10,True
2024-10-30,GSW,NOP,104,89,42,49,32,24,47.1,36.7,34.2,30.6,193,15,True
2024-10-30,IND,BOS,135,132,57,51,33,23,48.1,40.4,39.5,33.3,267,3,True
2024-10-30,LAC,POR,105,106,49,47,26,19,45.6,44.6,36.1,42.4,211,-1,False
2024-10-30,LAL,CLE,110,134,37,36,21,37,49.4,57.7,21.4,41.5,244,-24,False
2024-10-30,MEM,BRK,106,119,38,34,27,27,46.9,51.2,29.6,36.6,225,-13,False
2024-10-30,MIA,NYK,107,116,39,42,27,30,45.7,48.8,42.5,45.0,223,-9,False
2024-10-30,NOP,GSW,89,104,49,42,24,32,36.7,47.1,30.6,34.2,193,-15,False
2024-10-30,NYK,MIA,116,107,42,39,30,27,48.8,45.7,45.0,42.5,223,9,True
2024-10-30,OKC,SAS,105,93,39,52,28,22,46.1,41.2,41.5,33.3,198,12,True
2024-10-30,ORL,CHI,99,102,42,54,25,23,40.7,42.9,23.9,38.2,201,-3,False
2024-10-30,PHI,DET,95,105,37,49,17,23,41.8,46.2,28.6,41.7,200,-10,False
2024-10-30,POR,LAC,106,105,47,49,19,26,44.6,45.6,42.4,36.1,211,1,True
2024-10-30,SAS,OKC,93,105,52,39,22,28,41.2,46.1,33.3,41.5,198,-12,False
2024-10-30,TOR,CHO,133,138,41,38,37,31,57.1,52.1,32.1,44.4,271,-5,False
2024-10-30,WAS,ATL,133,120,37,41,32,28,53.4,47.4,42.1,30.8,253,13,True
2024-11-15,ATL,WAS,129,117,55,52,28,28,46.9,40.6,32.4,34.9,246,12,True
2024-11-15,BRK,NYK,122,124,37,45,27,25,43.8,53.0,41.3,34.2,246,-2,False
2024-11-15,CHI,CLE,126,144,36,40,32,33,51.1,54.8,47.6,48.8,270,-18,False
2024-11-15,CLE,CHI,144,126,40,36,33,32,54.8,51.1,48.8,47.6,270,18,True
2024-11-15,DEN,NOP,94,101,38,56,26,21,42.5,42.5,27.0,31.4,195,-7,False
2024-11-15,DET,TOR,99,95,56,53,24,21,41.1,36.1,21.1,25.8,194,4,True
2024-11-15,GSW,MEM,123,118,56,54,33,22,43.9,40.8,41.3,16.7,241,5,True
2024-11-15,HOU,LAC,125,104,48,51,31,12,48.4,37.8,43.2,25.0,229,21,True
2024-11-15,IND,MIA,111,124,39,36,28,27,51.2,51.7,40.0,35.7,235,-13,False
2024-11-15,LAC,HOU,104,125,51,48,12,31,37.8,48.4,25.0,43.2,229,-21,False
2024-11-15,LAL,SAS,120,115,41,40,27,32,50.0,48.9,45.2,37.8,235,5,True
2024-11-15,MEM,GSW,118,123,54,56,22,33,40.8,43.9,16.7,41.3,241,-5,False
2024-11-15,MIA,IND,124,111,36,39,27,28,51.7,51.2,35.7,40.0,235,13,True
2024-11-15,MIN,SAC,130,126,41,51,26,21,47.5,50.0,40.8,32.4,256,4,True
2024-11-15,NOP,DEN,101,94,56,38,21,26,42.5,42.5,31.4,27.0,195,7,True
2024-11-15,NYK,BRK,124,122,45,37,25,27,53.0,43.8,34.2,41.3,246,2,True
2024-11-15,OKC,PHO,99,83,53,50,21,17,39.6,29.3,25.0,24.3,182,16,True
2024-11-15,ORL,PHI,98,86,43,34,15,19,43.6,40.3,29.7,32.3,184,12,True
2024-11-15,PHI,ORL,86,98,34,43,19,15,40.3,43.6,32.3,29.7,184,-12,False
2024-11-15,PHO,OKC,83,99,50,53,17,21,29.3,39.6,24.3,25.0,182,-16,False
2024-11-15,SAC,MIN,126,130,51,41,21,26,50.0,47.5,32.4,40.8,256,-4,False
2024-11-15,SAS,LAL,115,120,40,41,32,27,48.9,50.0,37.8,45.2,235,-5,False
2024-11-15,TOR,DET,95,99,53,56,21,24,36.1,41.1,25.8,21.1,194,-4,False
2024-11-15,WAS,ATL,117,129,52,55,28,28,40.6,46.9,34.9,32.4,246,-12,False
2024-11-13,BOS,BRK,139,114,45,34,35,26,53.8,50.6,47.8,44.2,253,25,True
2024-11-13,BRK,BOS,114,139,34,45,26,35,50.6,53.8,44.2,47.8,253,-25,False
2024-11-13,CHI,NYK,124,123,40,40,31,31,53.7,51.1,38.9,40.5,247,1,True
2024-11-13,CLE,PHI,114,106,46,45,25,24,49.4,44.6,40.0,32.6,220,8,True
2024-11-13,DET,MIL,120,127,45,47,29,26,46.0,47.4,47.4,42.9,247,-7,False
2024-11-13,HOU,LAC,111,103,59,42,28,27,43.3,39.6,37.5,36.8,214,8,True
2024-11-13,IND,ORL,90,94,41,51,22,26,38.1,40.0,33.3,34.2,184,-4,False
2024-11-13,LAC,HOU,103,111,42,59,27,28,39.6,43.3,36.8,37.5,214,-8,False
2024-11-13,LAL,MEM,128,123,42,41,31,28,50.6,47.2,48.8,36.4,251,5,True
2024-11-13,MEM,LAL,123,128,41,42,28,31,47.2,50.6,36.4,48.8,251,-5,False
2024-11-13,MIL,DET,127,120,47,45,26,29,47.4,46.0,42.9,47.4,247,7,True
2024-11-13,MIN,POR,98,106,41,47,16,17,39.4,45.8,17.9,36.0,204,-8,False
2024-11-13,NOP,OKC,88,106,58,31,21,20,39.5,44.3,24.3,38.5,194,-18,False
2024-11-13,NYK,CHI,123,124,40,40,31,31,51.1,53.7,40.5,38.9,247,-1,False
2024-11-13,OKC,NOP,106,88,31,58,20,21,44.3,39.5,38.5,24.3,194,18,True
2024-11-13,ORL,IND,94,90,51,41,26,22,40.0,38.1,34.2,33.3,184,4,True
2024-11-13,PHI,CLE,106,114,45,46,24,25,44.6,49.4,32.6,40.0,220,-8,False
2024-11-13,PHO,SAC,104,127,40,45,23,38,37.1,64.1,30.2,53.6,231,-23,False
2024-11-13,POR,MIN,106,98,47,41,17,16,45.8,39.4,36.0,17.9,204,8,True
2024-11-13,SAC,PHO,127,104,45,40,38,23,64.1,37.1,53.6,30.2,231,23,True
2024-11-13,SAS,WAS,139,130,39,41,38,27,52.2,51.6,40.9,40.9,269,9,True
2024-11-13,WAS,SAS,130,139,41,39,27,38,51.6,52.2,40.9,40.9,269,-9,False
2025-01-29,BOS,CHI,122,100,45,47,32,28,47.1,40.2,40.9,30.6,222,22,True
2025-01-29,BRK,CHO,104,83,40,52,27,18,48.8,33.7,31.2,28.6,187,21,True
2025-01-29,CHI,BOS,100,122,47,45,28,32,40.2,47.1,30.6,40.9,222,-22,False
2025-01-29,CHO,BRK,83,104,52,40,18,27,33.7,48.8,28.6,31.2,187,-21,False
2025-01-29,CLE,MIA,126,106,47,35,29,27,54.0,47.0,31.0,34.9,232,20,True
2025-01-29,DAL,NOP,137,136,51,36,30,31,54.2,53.1,46.5,48.4,273,1,True
2025-01-29,DEN,NYK,112,122,47,35,21,33,48.8,51.6,35.7,41.2,234,-10,False
2025-01-29,DET,IND,119,133,41,36,26,28,49.4,56.8,35.3,50.0,252,-14,False
2025-01-29,GSW,OKC,116,109,42,50,30,21,49.4,40.4,34.2,23.1,225,7,True
2025-01-29,IND,DET,133,119,36,41,28,26,56.8,49.4,50.0,35.3,252,14,True
2025-01-29,LAC,SAS,128,116,57,30,26,27,52.7,48.3,50.0,33.3,244,12,True
2025-01-29,MIA,CLE,106,126,35,47,27,29,47.0,54.0,34.9,31.0,232,-20,False
2025-01-29,MIN,PHO,121,113,34,36,26,30,56.0,50.6,44.8,37.5,234,8,True
2025-01-29,NOP,DAL,136,137,36,51,31,30,53.1,54.2,48.4,46.5,273,-1,False
2025-01-29,NYK,DEN,122,112,35,47,33,21,51.6,48.8,41.2,35.7,234,10,True
2025-01-29,OKC,GSW,109,116,50,42,21,30,40.4,49.4,23.1,34.2,225,-7,False
2025-01-29,PHI,SAC,117,104,35,46,30,34,52.4,44.4,41.4,24.4,221,13,True
2025-01-29,PHO,MIN,113,121,36,34,30,26,50.6,56.0,37.5,44.8,234,-8,False
2025-01-29,SAC,PHI,104,117,46,35,34,30,44.4,52.4,24.4,41.4,221,-13,False
2025-01-29,SAS,LAC,116,128,30,57,27,26,48.3,52.7,33.3,50.0,244,-12,False
2025-01-29,TOR,WAS,106,82,36,43,31,17,47.7,38.9,35.5,16.7,188,24,True
2025-01-29,WAS,TOR,82,106,43,36,17,31,38.9,47.7,16.7,35.5,188,-24,False
2024-11-02,BOS,CHO,113,103,44,34,23,24,43.9,44.0,30.8,40.5,216,10,True
2024-11-02,CHO,BOS,103,113,34,44,24,23,44.0,43.9,40.5,30.8,216,-10,False
2024-11-02,CLE,MIL,114,113,45,45,31,24,48.4,48.3,39.5,46.2,227,1,True
2024-11-02,DEN,UTA,129,103,52,39,33,24,48.5,41.6,50.0,31.0,232,26,True
2024-11-02,GSW,HOU,127,121,47,49,26,27,51.3,41.1,46.9,33.3,248,6,True
2024-11-02,HOU,GSW,121,127,49,47,27,26,41.1,51.3,33.3,46.9,248,-6,False
2024-11-02,LAC,OKC,92,105,50,41,23,25,40.5,42.9,31.4,41.0,197,-13,False
2024-11-02,MEM,PHI,124,107,52,33,35,22,55.2,40.4,44.4,41.3,231,17,True
2024-11-02,MIA,WAS,118,98,65,44,19,23,42.2,41.8,40.5,20.0,216,20,True
2024-11-02,MIL,CLE,113,114,45,45,24,31,48.3,48.4,46.2,39.5,227,-1,False
2024-11-02,MIN,SAS,103,113,32,44,21,32,47.6,51.8,29.7,31.0,216,-10,False
2024-11-02,OKC,LAC,105,92,41,50,25,23,42.9,40.5,41.0,31.4,197,13,True
2024-11-02,PHI,MEM,107,124,33,52,22,35,40.4,55.2,41.3,44.4,231,-17,False
2024-11-02,PHO,POR,103,97,63,56,29,17,37.6,33.3,32.7,32.6,200,6,True
2024-11-02,POR,PHO,97,103,56,63,17,29,33.3,37.6,32.6,32.7,200,-6,False
2024-11-02,SAC,TOR,128,131,49,46,21,31,46.0,48.4,25.0,45.9,259,-3,False
2024-11-02,SAS,MIN,113,103,44,32,32,21,51.8,47.6,31.0,29.7,216,10,True
2024-11-02,TOR,SAC,131,128,46,49,31,21,48.4,46.0,45.9,25.0,259,3,True
2024-11-02,UTA,DEN,103,129,39,52,24,33,41.6,48.5,31.0,50.0,232,-26,False
2024-11-02,WAS,MIA,98,118,44,65,23,19,41.8,42.2,20.0,40.5,216,-20,False
2024-11-19,BOS,CLE,120,117,42,41,32,30,51.2,49.5,53.7,34.5,237,3,True
2024-11-19,BRK,CHO,116,115,36,44,31,25,49.4,46.3,43.9,54.1,231,1,True
2024-11-19,CHO,BRK,115,116,44,36,25,31,46.3,49.4,54.1,43.9,231,-1,False
2024-11-19,CLE,BOS,117,120,41,42,30,32,49.5,51.2,34.5,53.7,237,-3,False
2024-11-19,DAL,NOP,132,91,48,37,26,19,52.1,39.7,45.2,34.4,223,41,True
2024-11-19,DEN,MEM,122,110,53,55,29,24,48.0,39.8,33.3,23.7,232,12,True
2024-11-19,LAL,UTA,124,118,34,42,30,28,55.3,50.0,45.2,33.3,242,6,True
2024-11-19,MEM,DEN,110,122,55,53,24,29,39.8,48.0,23.7,33.3,232,-12,False
2024-11-19,NOP,DAL,91,132,37,48,19,26,39.7,52.1,34.4,45.2,223,-41,False
2024-11-19,OKC,SAS,104,110,47,46,24,32,41.0,47.0,30.2,41.3,214,-6,False
2024-11-19,SAS,OKC,110,104,46,47,32,24,47.0,41.0,41.3,30.2,214,6,True
2024-11-19,UTA,LAL,118,124,42,34,28,30,50.0,55.3,33.3,45.2,242,-6,False
2024-12-01,BOS,CLE,111,115,46,44,17,22,40.0,48.8,34.7,47.2,226,-4,False
2024-12-01,BRK,ORL,92,100,33,52,19,23,38.0,45.9,25.8,25.0,192,-8,False
2024-12-01,CLE,BOS,115,111,44,46,22,17,48.8,40.0,47.2,34.7,226,4,True
2024-12-01,DAL,POR,137,131,33,39,33,29,55.2,58.3,50.0,58.1,268,6,True
2024-12-01,DEN,LAC,122,126,39,42,37,28,58.0,47.8,41.7,46.2,248,-4,False
2024-12-01,HOU,OKC,119,116,51,46,20,30,41.3,44.7,35.1,33.3,235,3,True
2024-12-01,IND,MEM,121,136,41,40,28,36,47.8,52.7,33.3,34.8,257,-15,False
2024-12-01,LAC,DEN,126,122,42,39,28,37,47.8,58.0,46.2,41.7,248,4,True
2024-12-01,LAL,UTA,105,104,42,44,23,27,44.3,50.6,21.2,35.0,209,1,True
2024-12-01,MEM,IND,136,121,40,41,36,28,52.7,47.8,34.8,33.3,257,15,True
2024-12-01,MIA,TOR,116,119,45,47,25,30,44.3,53.4,37.5,34.5,235,-3,False
2024-12-01,NOP,NYK,85,118,42,60,20,30,37.2,45.7,14.8,44.4,203,-33,False
2024-12-01,NYK,NOP,118,85,60,42,30,20,45.7,37.2,44.4,14.8,203,33,True
2024-12-01,OKC,HOU,116,119,46,51,30,20,44.7,41.3,33.3,35.1,235,-3,False
2024-12-01,ORL,BRK,100,92,52,33,23,19,45.9,38.0,25.0,25.8,192,8,True
2024-12-01,POR,DAL,131,137,39,33,29,33,58.3,55.2,58.1,50.0,268,-6,False
2024-12-01,SAC,SAS,125,127,51,38,32,32,46.5,51.2,37.5,50.0,252,-2,False
2024-12-01,SAS,SAC,127,125,38,51,32,32,51.2,46.5,50.0,37.5,252,2,True
2024-12-01,TOR,MIA,119,116,47,45,30,25,53.4,44.3,34.5,37.5,235,3,True
2024-12-01,UTA,LAL,104,105,44,42,27,23,50.6,44.3,35.0,21.2,209,-1,False
2025-02-04,BOS,CLE,112,105,53,51,26,18,40.8,39.6,35.4,28.2,217,7,True
2025-02-04,BRK,HOU,99,97,39,45,26,23,46.3,41.0,37.0,34.4,196,2,True
2025-02-04,CHI,MIA,133,124,43,44,35,29,52.7,47.8,46.3,38.6,257,9,True
2025-02-04,CLE,BOS,105,112,51,53,18,26,39.6,40.8,28.2,35.4,217,-7,False
2025-02-04,DAL,PHI,116,118,44,34,24,37,47.1,54.7,33.3,33.3,234,-2,False
2025-02-04,HOU,BRK,97,99,45,39,23,26,41.0,46.3,34.4,37.0,196,-2,False
2025-02-04,IND,POR,89,112,39,51,25,23,42.0,44.6,20.8,37.8,201,-23,False
2025-02-04,LAC,LAL,97,122,36,50,30,33,38.2,55.6,29.3,48.6,219,-25,False
2025-02-04,LAL,LAC,122,97,50,36,33,30,55.6,38.2,48.6,29.3,219,25,True
2025-02-04,MIA,CHI,124,133,44,43,29,35,47.8,52.7,38.6,46.3,257,-9,False
2025-02-04,NYK,TOR,121,115,43,34,26,27,50.0,52.4,32.0,37.9,236,6,True
2025-02-04,PHI,DAL,118,116,34,44,37,24,54.7,47.1,33.3,33.3,234,2,True
2025-02-04,POR,IND,112,89,51,39,23,25,44.6,42.0,37.8,20.8,201,23,True
2025-02-04,TOR,NYK,115,121,34,43,27,26,52.4,50.0,37.9,32.0,236,-6,False
2025-02-06,BOS,DAL,120,127,40,35,30,32,51.7,55.7,43.2,45.5,247,-7,False
2025-02-06,DAL,BOS,127,120,35,40,32,30,55.7,51.7,45.5,43.2,247,7,True
2025-02-06,DEN,ORL,112,90,52,40,33,21,53.0,36.9,40.0,16.1,202,22,True
2025-02-06,GSW,LAL,112,120,40,47,29,26,40.6,50.0,30.2,37.1,232,-8,False
2025-02-06,HOU,MIN,114,127,39,47,26,23,48.8,47.9,38.7,41.0,241,-13,False
2025-02-06,IND,LAC,119,112,46,48,31,25,45.3,46.6,33.3,42.5,231,7,True
2025-02-06,LAC,IND,112,119,48,46,25,31,46.6,45.3,42.5,33.3,231,-7,False
2025-02-06,LAL,GSW,120,112,47,40,26,29,50.0,40.6,37.1,30.2,232,8,True
2025-02-06,MIN,HOU,127,114,47,39,23,26,47.9,48.8,41.0,38.7,241,13,True
2025-02-06,ORL,DEN,90,112,40,52,21,33,36.9,53.0,16.1,40.0,202,-22,False
2025-02-06,POR,SAC,108,102,47,47,25,21,43.3,42.0,40.0,33.3,210,6,True
2025-02-06,SAC,POR,102,108,47,47,21,25,42.0,43.3,33.3,40.0,210,-6,False
2024-10-26,BOS,DET,124,118,37,44,19,27,42.2,48.9,45.8,35.9,242,6,True
2024-10-26,CHI,OKC,95,114,61,54,23,21,34.8,42.1,28.3,20.0,209,-19,False
2024-10-26,CHO,MIA,106,114,46,43,20,33,43.8,46.5,31.7,41.2,220,-8,False
2024-10-26,CLE,WAS,135,116,48,46,27,25,53.4,38.5,46.2,34.9,251,19,True
2024-10-26,DAL,PHO,102,114,46,47,22,26,39.8,45.0,31.7,35.9,216,-12,False
2024-10-26,DEN,LAC,104,109,37,44,20,30,40.2,48.8,40.0,36.4,213,-5,False
2024-10-26,DET,BOS,118,124,44,37,27,19,48.9,42.2,35.9,45.8,242,-6,False
2024-10-26,HOU,SAS,106,109,34,49,21,23,41.3,49.4,31.7,40.0,215,-3,False
2024-10-26,LAC,DEN,109,104,44,37,30,20,48.8,40.2,36.4,40.0,213,5,True
2024-10-26,LAL,SAC,131,127,45,32,32,32,52.2,51.1,41.2,34.1,258,4,True
2024-10-26,MEM,ORL,124,111,42,41,38,21,53.5,42.5,38.2,35.4,235,13,True
2024-10-26,MIA,CHO,114,106,43,46,33,20,46.5,43.8,41.2,31.7,220,8,True
2024-10-26,MIN,TOR,112,101,41,46,29,29,47.0,45.6,37.8,34.5,213,11,True
2024-10-26,OKC,CHI,114,95,54,61,21,23,42.1,34.8,20.0,28.3,209,19,True
2024-10-26,ORL,MEM,111,124,41,42,21,38,42.5,53.5,35.4,38.2,235,-13,False
2024-10-26,PHO,DAL,114,102,47,46,26,22,45.0,39.8,35.9,31.7,216,12,True
2024-10-26,SAC,LAL,127,131,32,45,32,32,51.1,52.2,34.1,41.2,258,-4,False
2024-10-26,SAS,HOU,109,106,49,34,23,21,49.4,41.3,40.0,31.7,215,3,True
2024-10-26,TOR,MIN,101,112,46,41,29,29,45.6,47.0,34.5,37.8,213,-11,False
2024-10-26,WAS,CLE,116,135,46,48,25,27,38.5,53.4,34.9,46.2,251,-19,False
2024-12-12,BOS,DET,123,99,51,43,34,27,51.1,42.9,41.7,18.9,222,24,True
2024-12-12,DET,BOS,99,123,43,51,27,34,42.9,51.1,18.9,41.7,222,-24,False
2024-12-12,MIA,TOR,114,104,52,42,21,29,48.2,44.6,40.6,34.4,218,10,True
2024-12-12,NOP,SAC,109,111,43,50,22,24,47.0,40.2,37.8,30.3,220,-2,False
2024-12-12,SAC,NOP,111,109,50,43,24,22,40.2,47.0,30.3,37.8,220,2,True
2024-12-12,TOR,MIA,104,114,42,52,29,21,44.6,48.2,34.4,40.6,218,-10,False
2024-12-27,BOS,IND,142,105,52,39,31,27,51.1,41.8,41.1,28.2,247,37,True
2024-12-27,BRK,SAS,87,96,45,43,22,26,38.9,41.0,29.3,41.4,183,-9,False
2024-12-27,CLE,DEN,149,135,38,38,40,39,56.2,56.4,47.9,48.4,284,14,True
2024-12-27,DAL,PHO,98,89,41,42,24,23,43.8,38.6,35.3,37.1,187,9,True
2024-12-27,DEN,CLE,135,149,38,38,39,40,56.4,56.2,48.4,47.9,284,-14,False
2024-12-27,GSW,LAC,92,102,47,39,24,19,36.8,53.3,18.4,31.2,194,-10,False
2024-12-27,HOU,MIN,112,113,48,39,19,25,48.9,50.6,33.3,48.8,225,-1,False
2024-12-27,IND,BOS,105,142,39,52,27,31,41.8,51.1,28.2,41.1,247,-37,False
2024-12-27,LAC,GSW,102,92,39,47,19,24,53.3,36.8,31.2,18.4,194,10,True
2024-12-27,MEM,NOP,132,124,42,45,30,30,47.2,44.8,41.5,28.9,256,8,True
2024-12-27,MIN,HOU,113,112,39,48,25,19,50.6,48.9,48.8,33.3,225,1,True
2024-12-27,NOP,MEM,124,132,45,42,30,30,44.8,47.2,28.9,41.5,256,-8,False
2024-12-27,NYK,ORL,108,85,44,33,18,20,53.3,36.8,26.7,30.3,193,23,True
2024-12-27,ORL,NYK,85,108,33,44,20,18,36.8,53.3,30.3,26.7,193,-23,False
2024-12-27,PHO,DAL,89,98,42,41,23,24,38.6,43.8,37.1,35.3,187,-9,False
2024-12-27,SAS,BRK,96,87,43,45,26,22,41.0,38.9,41.4,29.3,183,9,True
2024-12-07,BOS,MEM,121,127,51,52,26,25,40.0,50.0,30.0,45.5,248,-6,False
2024-12-07,CHO,CLE,102,116,37,47,21,28,43.0,50.0,28.2,36.8,218,-14,False
2024-12-07,CLE,CHO,116,102,47,37,28,21,50.0,43.0,36.8,28.2,218,14,True
2024-12-07,DAL,TOR,125,118,52,39,21,37,46.9,46.2,37.8,38.5,243,7,True
2024-12-07,DEN,WAS,113,122,48,46,34,31,48.9,48.4,20.8,39.0,235,-9,False
2024-12-07,DET,NYK,120,111,43,31,28,27,51.8,53.2,50.0,32.4,231,9,True
2024-12-07,MEM,BOS,127,121,52,51,25,26,50.0,40.0,45.5,30.0,248,6,True
2024-12-07,MIA,PHO,121,111,41,41,30,29,52.3,43.9,40.6,39.0,232,10,True
2024-12-07,NOP,OKC,109,119,35,45,25,27,48.1,52.9,29.7,37.5,228,-10,False
2024-12-07,NYK,DET,111,120,31,43,27,28,53.2,51.8,32.4,50.0,231,-9,False
2024-12-07,OKC,NOP,119,109,45,35,27,25,52.9,48.1,37.5,29.7,228,10,True
2024-12-07,PHO,MIA,111,121,41,41,29,30,43.9,52.3,39.0,40.6,232,-10,False
2024-12-07,TOR,DAL,118,125,39,52,37,21,46.2,46.9,38.5,37.8,243,-7,False
2024-12-07,WAS,DEN,122,113,46,48,31,34,48.4,48.9,39.0,20.8,235,9,True
2024-11-10,BOS,MIL,113,107,42,41,27,21,40.7,48.1,38.0,40.6,220,6,True
2024-11-10,CHO,PHI,105,107,50,40,22,24,37.9,46.4,25.9,27.3,212,-2,False
2024-11-10,DAL,DEN,120,122,42,45,29,35,53.3,50.6,30.3,48.3,242,-2,False
2024-11-10,DEN,DAL,122,120,45,42,35,29,50.6,53.3,48.3,30.3,242,2,True
2024-11-10,DET,HOU,99,101,46,53,21,19,42.9,40.9,32.4,20.6,200,-2,False
2024-11-10,GSW,OKC,127,116,46,41,35,25,50.6,44.7,48.8,33.3,243,11,True
2024-11-10,HOU,DET,101,99,53,46,19,21,40.9,42.9,20.6,32.4,200,2,True
2024-11-10,IND,NYK,132,121,32,39,27,23,51.1,55.4,45.7,28.0,253,11,True
2024-11-10,LAL,TOR,123,103,33,40,30,26,51.2,45.1,32.4,34.5,226,20,True
2024-11-10,MEM,POR,134,89,51,43,32,18,55.3,34.0,37.2,9.5,223,45,True
2024-11-10,MIA,MIN,95,94,43,47,18,22,44.2,39.8,35.5,28.9,189,1,True
2024-11-10,MIL,BOS,107,113,41,42,21,27,48.1,40.7,40.6,38.0,220,-6,False
2024-11-10,MIN,MIA,94,95,47,43,22,18,39.8,44.2,28.9,35.5,189,-1,False
2024-11-10,NYK,IND,121,132,39,32,23,27,55.4,51.1,28.0,45.7,253,-11,False
2024-11-10,OKC,GSW,116,127,41,46,25,35,44.7,50.6,33.3,48.8,243,-11,False
2024-11-10,ORL,WAS,121,94,44,37,25,20,45.1,45.8,35.4,30.3,215,27,True
2024-11-10,PHI,CHO,107,105,40,50,24,22,46.4,37.9,27.3,25.9,212,2,True
2024-11-10,PHO,SAC,118,127,48,57,30,23,41.9,49.0,31.6,29.7,245,-9,False
2024-11-10,POR,MEM,89,134,43,51,18,32,34.0,55.3,9.5,37.2,223,-45,False
2024-11-10,SAC,PHO,127,118,57,48,23,30,49.0,41.9,29.7,31.6,245,9,True
2024-11-10,TOR,LAL,103,123,40,33,26,30,45.1,51.2,34.5,32.4,226,-20,False
2024-11-10,WAS,ORL,94,121,37,44,20,25,45.8,45.1,30.3,35.4,215,-27,False
2024-11-24,BOS,MIN,107,105,40,49,25,19,42.5,42.0,37.5,36.6,212,2,True
2024-11-24,BRK,SAC,108,103,31,44,24,21,48.0,48.1,48.7,36.0,211,5,True
2024-11-24,CLE,TOR,122,108,49,55,27,22,49.5,40.2,39.0,30.8,230,14,True
2024-11-24,DAL,MIA,118,123,59,57,29,27,41.9,43.0,25.0,34.1,241,-5,False
2024-11-24,IND,WAS,115,103,45,41,31,24,47.7,45.6,44.4,31.4,218,12,True
2024-11-24,LAC,PHI,125,99,44,33,31,22,58.0,39.5,40.0,23.1,224,26,True
2024-11-24,MIA,DAL,123,118,57,59,27,29,43.0,41.9,34.1,25.0,241,5,True
2024-11-24,MIN,BOS,105,107,49,40,19,25,42.0,42.5,36.6,37.5,212,-2,False
2024-11-24,PHI,LAC,99,125,33,44,22,31,39.5,58.0,23.1,40.0,224,-26,False
2024-11-24,SAC,BRK,103,108,44,31,21,24,48.1,48.0,36.0,48.7,211,-5,False
2024-11-24,TOR,CLE,108,122,55,49,22,27,40.2,49.5,30.8,39.0,230,-14,False
2024-11-24,WAS,IND,103,115,41,45,24,31,45.6,47.7,31.4,44.4,218,-12,False
2025-01-02,BOS,MIN,118,115,31,41,30,24,50.0,50.0,38.6,53.8,233,3,True
2025-01-02,BRK,MIL,113,110,51,46,26,21,43.2,44.4,30.8,29.7,223,3,True
2025-01-02,GSW,PHI,139,105,43,33,41,17,60.9,42.0,56.4,29.0,244,34,True
2025-01-02,IND,MIA,128,115,39,39,35,34,53.1,57.3,42.5,42.3,243,13,True
2025-01-02,LAC,OKC,98,116,45,35,25,29,46.9,50.0,34.4,36.8,214,-18,False
2025-01-02,LAL,POR,114,106,43,42,30,24,45.7,50.0,34.9,34.6,220,8,True
2025-01-02,MIA,IND,115,128,39,39,34,35,57.3,53.1,42.3,42.5,243,-13,False
2025-01-02,MIL,BRK,110,113,46,51,21,26,44.4,43.2,29.7,30.8,223,-3,False
2025-01-02,MIN,BOS,115,118,41,31,24,30,50.0,50.0,53.8,38.6,233,-3,False
2025-01-02,OKC,LAC,116,98,35,45,29,25,50.0,46.9,36.8,34.4,214,18,True
2025-01-02,PHI,GSW,105,139,33,43,17,41,42.0,60.9,29.0,56.4,244,-34,False
2025-01-02,POR,LAL,106,114,42,43,24,30,50.0,45.7,34.6,34.9,220,-8,False
2025-01-12,BOS,NOP,120,119,55,42,23,24,43.6,46.5,29.5,45.9,239,1,True
2025-01-12,BRK,UTA,111,112,54,41,26,25,42.4,44.4,25.0,38.6,223,-1,False
2025-01-12,CHI,SAC,119,124,45,53,26,33,46.2,49.5,48.6,33.3,243,-5,False
2025-01-12,CHO,PHO,113,120,52,39,30,31,44.6,48.3,37.5,41.5,233,-7,False
2025-01-12,CLE,IND,93,108,44,50,24,30,39.8,46.7,26.8,31.4,201,-15,False
2025-01-12,DAL,DEN,101,112,37,55,27,23,41.2,48.9,35.3,21.9,213,-11,False
2025-01-12,DEN,DAL,112,101,55,37,23,27,48.9,41.2,21.9,35.3,213,11,True
2025-01-12,IND,CLE,108,93,50,44,30,24,46.7,39.8,31.4,26.8,201,15,True
2025-01-12,MIL,NYK,106,140,39,49,22,29,45.7,58.0,29.4,43.9,246,-34,False
2025-01-12,NOP,BOS,119,120,42,55,24,23,46.5,43.6,45.9,29.5,239,-1,False
2025-01-12,NYK,MIL,140,106,49,39,29,22,58.0,45.7,43.9,29.4,246,34,True
2025-01-12,OKC,WAS,136,95,56,39,26,20,47.4,33.7,37.1,19.6,231,41,True
2025-01-12,ORL,PHI,104,99,41,29,23,17,48.8,45.8,23.3,41.4,203,5,True
2025-01-12,PHI,ORL,99,104,29,41,17,23,45.8,48.8,41.4,23.3,203,-5,False
2025-01-12,PHO,CHO,120,113,39,52,31,30,48.3,44.6,41.5,37.5,233,7,True
2025-01-12,SAC,CHI,124,119,53,45,33,26,49.5,46.2,33.3,48.6,243,5,True
2025-01-12,UTA,BRK,112,111,41,54,25,26,44.4,42.4,38.6,25.0,223,1,True
2025-01-12,WAS,OKC,95,136,39,56,20,26,33.7,47.4,19.6,37.1,231,-41,False
2025-01-31,BOS,NOP,118,116,35,48,32,16,50.0,48.9,39.0,40.5,234,2,True
2025-01-31,CHI,TOR,122,106,52,44,34,27,50.6,42.4,45.0,33.3,228,16,True
2025-01-31,CHO,LAC,104,112,42,45,18,26,43.8,54.3,23.3,39.3,216,-8,False
2025-01-31,DAL,DET,102,117,46,47,20,18,42.5,44.3,33.3,25.7,219,-15,False
2025-01-31,DEN,PHI,137,134,35,27,39,29,65.9,55.6,52.2,52.5,271,3,True
2025-01-31,DET,DAL,117,102,47,46,18,20,44.3,42.5,25.7,33.3,219,15,True
2025-01-31,GSW,PHO,105,130,49,48,26,41,37.5,56.2,36.4,48.7,235,-25,False
2025-01-31,LAC,CHO,112,104,45,42,26,18,54.3,43.8,39.3,23.3,216,8,True
2025-01-31,MIL,SAS,118,144,47,53,24,37,43.0,49.0,32.4,48.0,262,-26,False
2025-01-31,NOP,BOS,116,118,48,35,16,32,48.9,50.0,40.5,39.0,234,-2,False
2025-01-31,PHI,DEN,134,137,27,35,29,39,55.6,65.9,52.5,52.2,271,-3,False
2025-01-31,PHO,GSW,130,105,48,49,41,26,56.2,37.5,48.7,36.4,235,25,True
2025-01-31,SAS,MIL,144,118,53,47,37,24,49.0,43.0,48.0,32.4,262,26,True
2025-01-31,TOR,CHI,106,122,44,52,27,34,42.4,50.6,33.3,45.0,228,-16,False
2024-10-22,BOS,NYK,132,109,40,34,33,20,50.5,55.1,47.5,36.7,241,23,True
2024-10-22,LAL,MIN,110,103,46,47,22,17,44.2,41.2,16.7,31.7,213,7,True
2024-10-22,MIN,LAL,103,110,47,46,17,22,41.2,44.2,31.7,16.7,213,-7,False
2024-10-22,NYK,BOS,109,132,34,40,20,33,55.1,50.5,36.7,47.5,241,-23,False
2025-01-05,BOS,OKC,92,105,48,46,17,22,36.5,44.8,19.6,42.1,197,-13,False
2025-01-05,CHO,CLE,105,115,48,41,19,29,41.8,47.8,35.7,34.9,220,-10,False
2025-01-05,CLE,CHO,115,105,41,48,29,19,47.8,41.8,34.9,35.7,220,10,True
2025-01-05,GSW,SAC,99,129,35,43,22,31,45.7,51.7,34.3,44.2,228,-30,False
2025-01-05,HOU,LAL,119,115,49,39,19,26,47.5,48.7,35.0,44.4,234,4,True
2025-01-05,LAL,HOU,115,119,39,49,26,19,48.7,47.5,44.4,35.0,234,-4,False
2025-01-05,NOP,WAS,110,98,49,46,26,25,41.1,42.7,36.7,26.8,208,12,True
2025-01-05,OKC,BOS,105,92,46,48,22,17,44.8,36.5,42.1,19.6,197,13,True
2025-01-05,ORL,UTA,92,105,43,50,25,21,35.7,48.1,29.8,34.4,197,-13,False
2025-01-05,SAC,GSW,129,99,43,35,31,22,51.7,45.7,44.2,34.3,228,30,True
2025-01-05,UTA,ORL,105,92,50,43,21,25,48.1,35.7,34.4,29.8,197,13,True
2025-01-05,WAS,NOP,98,110,46,49,25,26,42.7,41.1,26.8,36.7,208,-12,False
2025-01-17,BOS,ORL,121,94,41,37,25,15,52.5,41.5,45.9,15.6,215,27,True
2025-01-17,BRK,LAL,101,102,45,34,28,24,45.1,46.3,44.7,35.3,203,-1,False
2025-01-17,CHI,CHO,123,125,45,44,34,26,50.5,50.0,35.0,38.2,248,-2,False
2025-01-17,CHO,CHI,125,123,44,45,26,34,50.0,50.5,38.2,35.0,248,2,True
2025-01-17,DAL,OKC,106,98,43,46,25,24,49.3,38.5,39.0,43.5,204,8,True
2025-01-17,DEN,MIA,133,113,41,41,35,30,54.3,49.5,48.5,27.3,246,20,True
2025-01-17,LAL,BRK,102,101,34,45,24,28,46.3,45.1,35.3,44.7,203,1,True
2025-01-17,MEM,SAS,140,112,41,40,39,29,56.7,47.6,43.2,36.1,252,28,True
2025-01-17,MIA,DEN,113,133,41,41,30,35,49.5,54.3,27.3,48.5,246,-20,False
2025-01-17,MIL,TOR,130,112,44,43,25,31,51.9,47.3,41.9,23.5,242,18,True
2025-01-17,MIN,NYK,116,99,46,41,23,19,53.2,38.9,55.0,41.2,215,17,True
2025-01-17,NOP,UTA,136,123,56,40,34,30,47.0,50.0,44.0,34.2,259,13,True
2025-01-17,NYK,MIN,99,116,41,46,19,23,38.9,53.2,41.2,55.0,215,-17,False
2025-01-17,OKC,DAL,98,106,46,43,24,25,38.5,49.3,43.5,39.0,204,-8,False
2025-01-17,ORL,BOS,94,121,37,41,15,25,41.5,52.5,15.6,45.9,215,-27,False
2025-01-17,SAS,MEM,112,140,40,41,29,39,47.6,56.7,36.1,43.2,252,-28,False
2025-01-17,TOR,MIL,112,130,43,44,31,25,47.3,51.9,23.5,41.9,242,-18,False
2025-01-17,UTA,NOP,123,136,40,56,30,34,50.0,47.0,34.2,44.0,259,-13,False
2024-12-25,BOS,PHI,114,118,51,39,24,28,45.3,46.6,40.8,42.5,232,-4,False
2024-12-25,DAL,MIN,99,105,43,46,15,23,41.4,46.5,37.2,43.8,204,-6,False
2024-12-25,DEN,PHO,100,110,46,42,20,31,46.2,46.6,27.6,30.6,210,-10,False
2024-12-25,GSW,LAL,113,115,44,41,26,30,46.1,45.1,40.0,35.7,228,-2,False
2024-12-25,LAL,GSW,115,113,41,44,30,26,45.1,46.1,35.7,40.0,228,2,True
2024-12-25,MIN,DAL,105,99,46,43,23,15,46.5,41.4,43.8,37.2,204,6,True
2024-12-25,NYK,SAS,117,114,47,45,26,33,45.0,50.6,33.3,42.1,231,3,True
2024-12-25,PHI,BOS,118,114,39,51,28,24,46.6,45.3,42.5,40.8,232,4,True
2024-12-25,PHO,DEN,110,100,42,46,31,20,46.6,46.2,30.6,27.6,210,10,True
2024-12-25,SAS,NYK,114,117,45,47,33,26,50.6,45.0,42.1,33.3,231,-3,False
2025-02-02,BOS,PHI,118,110,38,46,34,20,50.0,45.1,42.9,46.9,228,8,True
2025-02-02,CHI,DET,119,127,44,42,28,38,46.1,54.5,36.5,33.3,246,-8,False
2025-02-02,CLE,DAL,144,101,51,45,39,22,57.0,38.8,57.8,20.9,245,43,True
2025-02-02,DAL,CLE,101,144,45,51,22,39,38.8,57.0,20.9,57.8,245,-43,False
2025-02-02,DET,CHI,127,119,42,44,38,28,54.5,46.1,33.3,36.5,246,8,True
2025-02-02,LAC,TOR,108,115,41,43,21,31,46.6,51.8,32.1,52.0,223,-7,False
2025-02-02,MEM,MIL,132,119,61,36,37,32,48.6,48.4,35.9,44.4,251,13,True
2025-02-02,MIL,MEM,119,132,36,61,32,37,48.4,48.6,44.4,35.9,251,-13,False
2025-02-02,PHI,BOS,110,118,46,38,20,34,45.1,50.0,46.9,42.9,228,-8,False
2025-02-02,TOR,LAC,115,108,43,41,31,21,51.8,46.6,52.0,32.1,223,7,True
2025-01-10,BOS,SAC,97,114,43,56,22,26,40.5,43.1,26.8,38.3,211,-17,False
2025-01-10,BRK,DEN,105,124,39,49,26,34,42.2,51.7,31.1,37.5,229,-19,False
2025-01-10,CHI,WAS,138,105,55,45,39,26,55.8,39.8,46.9,39.1,243,33,True
2025-01-10,DEN,BRK,124,105,49,39,34,26,51.7,42.2,37.5,31.1,229,19,True
2025-01-10,GSW,IND,96,108,42,48,25,27,41.8,52.4,26.3,33.3,204,-12,False
2025-01-10,IND,GSW,108,96,48,42,27,25,52.4,41.8,33.3,26.3,204,12,True
2025-01-10,MIL,ORL,109,106,43,44,18,20,51.8,43.0,36.0,35.0,215,3,True
2025-01-10,NOP,PHI,123,115,44,42,31,23,48.4,46.2,45.0,36.8,238,8,True
2025-01-10,NYK,OKC,101,126,43,46,18,20,38.5,53.9,12.9,51.9,227,-25,False
2025-01-10,OKC,NYK,126,101,46,43,20,18,53.9,38.5,51.9,12.9,227,25,True
2025-01-10,ORL,MIL,106,109,44,43,20,18,43.0,51.8,35.0,36.0,215,-3,False
2025-01-10,PHI,NOP,115,123,42,44,23,31,46.2,48.4,36.8,45.0,238,-8,False
2025-01-10,SAC,BOS,114,97,56,43,26,22,43.1,40.5,38.3,26.8,211,17,True
2025-01-10,WAS,CHI,105,138,45,55,26,39,39.8,55.8,39.1,46.9,243,-33,False
2024-11-16,BOS,TOR,126,123,42,46,30,35,44.4,51.0,34.4,39.1,249,3,True
2024-11-16,CHO,MIL,115,114,53,40,25,31,44.1,51.1,35.7,41.7,229,1,True
2024-11-16,DAL,SAS,110,93,53,45,26,21,46.8,31.8,25.8,27.5,203,17,True
2024-11-16,LAL,NOP,104,99,43,50,24,24,43.8,42.2,30.0,37.9,203,5,True
2024-11-16,MIL,CHO,114,115,40,53,31,25,51.1,44.1,41.7,35.7,229,-1,False
2024-11-16,NOP,LAL,99,104,50,43,24,24,42.2,43.8,37.9,30.0,203,-5,False
2024-11-16,SAC,UTA,121,117,35,33,24,16,50.6,49.3,46.3,46.2,238,4,True
2024-11-16,SAS,DAL,93,110,45,53,21,26,31.8,46.8,27.5,25.8,203,-17,False
2024-11-16,TOR,BOS,123,126,46,42,35,30,51.0,44.4,39.1,34.4,249,-3,False
2024-11-16,UTA,SAC,117,121,33,35,16,24,49.3,50.6,46.2,46.3,238,-4,False
2024-12-31,BOS,TOR,125,71,49,44,29,18,54.0,31.4,51.2,25.0,196,54,True
2024-12-31,CLE,LAL,122,110,48,43,32,26,48.4,44.2,39.1,25.7,232,12,True
2024-12-31,IND,MIL,112,120,50,51,26,27,44.4,46.4,35.1,36.4,232,-8,False
2024-12-31,LAC,SAS,86,122,41,58,17,37,34.5,49.0,26.8,22.5,208,-36,False
2024-12-31,LAL,CLE,110,122,43,48,26,32,44.2,48.4,25.7,39.1,232,-12,False
2024-12-31,MEM,PHO,117,112,51,43,27,28,42.6,45.7,34.1,30.0,229,5,True
2024-12-31,MIL,IND,120,112,51,50,27,26,46.4,44.4,36.4,35.1,232,8,True
2024-12-31,MIN,OKC,105,113,43,37,21,25,49.4,47.2,39.5,33.3,218,-8,False
2024-12-31,OKC,MIN,113,105,37,43,25,21,47.2,49.4,33.3,39.5,218,8,True
2024-12-31,PHO,MEM,112,117,43,51,28,27,45.7,42.6,30.0,34.1,229,-5,False
2024-12-31,SAS,LAC,122,86,58,41,37,17,49.0,34.5,22.5,26.8,208,36,True
2024-12-31,TOR,BOS,71,125,44,49,18,29,31.4,54.0,25.0,51.2,196,-54,False
2024-10-24,BOS,WAS,122,102,49,40,21,27,46.7,43.2,37.8,19.4,224,20,True
2024-10-24,DAL,SAS,120,109,50,52,27,30,41.2,45.3,43.2,33.3,229,11,True
2024-10-24,DEN,OKC,87,102,57,49,29,23,35.7,42.6,18.4,22.2,189,-15,False
2024-10-24,MIN,SAC,117,115,42,38,24,21,47.7,46.3,40.0,37.9,232,2,True
2024-10-24,OKC,DEN,102,87,49,57,23,29,42.6,35.7,22.2,18.4,189,15,True
2024-10-24,SAC,MIN,115,117,38,42,21,24,46.3,47.7,37.9,40.0,232,-2,False
2024-10-24,SAS,DAL,109,120,52,50,30,27,45.3,41.2,33.3,43.2,229,-11,False
2024-10-24,WAS,BOS,102,122,40,49,27,21,43.2,46.7,19.4,37.8,224,-20,False
2024-12-15,BOS,WAS,112,98,56,51,26,22,43.0,40.4,39.1,32.5,210,14,True
2024-12-15,DAL,GSW,143,133,47,37,36,39,59.8,47.6,51.2,50.0,276,10,True
2024-12-15,GSW,DAL,133,143,37,47,39,36,47.6,59.8,50.0,51.2,276,-10,False
2024-12-15,IND,NOP,119,104,43,49,33,18,50.6,39.2,42.1,30.3,223,15,True
2024-12-15,LAL,MEM,116,110,44,50,23,25,47.6,39.2,29.4,32.1,226,6,True
2024-12-15,MEM,LAL,110,116,50,44,25,23,39.2,47.6,32.1,29.4,226,-6,False
2024-12-15,MIN,SAS,106,92,51,50,26,34,40.0,40.7,34.3,24.4,198,14,True
2024-12-15,NOP,IND,104,119,49,43,18,33,39.2,50.6,30.3,42.1,223,-15,False
2024-12-15,NYK,ORL,100,91,45,39,20,24,46.5,41.9,41.7,30.0,191,9,True
2024-12-15,ORL,NYK,91,100,39,45,24,20,41.9,46.5,30.0,41.7,191,-9,False
2024-12-15,PHO,POR,116,109,46,48,23,30,48.3,44.7,38.5,30.6,225,7,True
2024-12-15,POR,PHO,109,116,48,46,30,23,44.7,48.3,30.6,38.5,225,-7,False
2024-12-15,SAS,MIN,92,106,50,51,34,26,40.7,40.0,24.4,34.3,198,-14,False
2024-12-15,WAS,BOS,98,112,51,56,22,26,40.4,43.0,32.5,39.1,210,-14,False
2024-12-16,BRK,CLE,101,130,35,42,25,33,42.0,53.1,41.2,40.4,231,-29,False
2024-12-16,CHI,TOR,122,121,41,44,33,28,46.2,48.9,35.0,34.6,243,1,True
2024-12-16,CHO,PHI,108,121,38,42,30,21,50.6,51.2,31.6,42.1,229,-13,False
2024-12-16,CLE,BRK,130,101,42,35,33,25,53.1,42.0,40.4,41.2,231,29,True
2024-12-16,DEN,SAC,130,129,55,42,38,28,50.0,48.0,35.7,34.3,259,1,True
2024-12-16,DET,MIA,125,124,52,44,32,30,48.9,45.5,50.0,27.9,249,1,True
2024-12-16,LAC,UTA,144,107,41,35,28,22,59.8,45.0,53.8,33.3,251,37,True
2024-12-16,MIA,DET,124,125,44,52,30,32,45.5,48.9,27.9,50.0,249,-1,False
2024-12-16,PHI,CHO,121,108,42,38,21,30,51.2,50.6,42.1,31.6,229,13,True
2024-12-16,SAC,DEN,129,130,42,55,28,38,48.0,50.0,34.3,35.7,259,-1,False
2024-12-16,TOR,CHI,121,122,44,41,28,33,48.9,46.2,34.6,35.0,243,-1,False
2024-12-16,UTA,LAC,107,144,35,41,22,28,45.0,59.8,33.3,53.8,251,-37,False
2024-10-29,BRK,DEN,139,144,41,43,37,31,51.0,51.7,38.5,48.1,283,-5,False
2024-10-29,DAL,MIN,120,114,40,42,25,33,48.4,50.6,41.0,48.7,234,6,True
2024-10-29,DEN,BRK,144,139,43,41,31,37,51.7,51.0,48.1,38.5,283,5,True
2024-10-29,GSW,NOP,124,106,34,44,34,23,47.4,54.1,45.7,40.9,230,18,True
2024-10-29,MIN,DAL,114,120,42,40,33,25,50.6,48.4,48.7,41.0,234,-6,False
2024-10-29,NOP,GSW,106,124,44,34,23,34,54.1,47.4,40.9,45.7,230,-18,False
2024-10-29,SAC,UTA,113,96,49,42,26,24,52.2,39.3,25.8,29.2,209,17,True
2024-10-29,UTA,SAC,96,113,42,49,24,26,39.3,52.2,29.2,25.8,209,-17,False
2025-01-08,BRK,DET,98,113,38,42,24,30,38.4,52.3,33.3,40.5,211,-15,False
2025-01-08,CHI,IND,113,129,39,46,23,37,51.2,52.0,34.3,34.5,242,-16,False
2025-01-08,CLE,OKC,129,122,40,38,36,35,52.2,53.3,41.7,35.5,251,7,True
2025-01-08,DEN,LAC,126,103,45,40,29,14,55.1,37.5,48.6,28.9,229,23,True
2025-01-08,DET,BRK,113,98,42,38,30,24,52.3,38.4,40.5,33.3,211,15,True
2025-01-08,IND,CHI,129,113,46,39,37,23,52.0,51.2,34.5,34.3,242,16,True
2025-01-08,LAC,DEN,103,126,40,45,14,29,37.5,55.1,28.9,48.6,229,-23,False
2025-01-08,MIL,SAS,121,105,57,46,26,24,47.8,36.8,45.2,34.6,226,16,True
2025-01-08,NOP,POR,100,119,41,44,19,24,44.4,54.5,32.4,36.1,219,-19,False
2025-01-08,NYK,TOR,112,98,43,33,24,25,47.7,49.4,36.4,38.5,210,14,True
2025-01-08,OKC,CLE,122,129,38,40,35,36,53.3,52.2,35.5,41.7,251,-7,False
2025-01-08,PHI,WAS,109,103,36,51,21,26,45.5,44.7,34.1,43.3,212,6,True
2025-01-08,POR,NOP,119,100,44,41,24,19,54.5,44.4,36.1,32.4,219,19,True
2025-01-08,SAS,MIL,105,121,46,57,24,26,36.8,47.8,34.6,45.2,226,-16,False
2025-01-08,TOR,NYK,98,112,33,43,25,24,49.4,47.7,38.5,36.4,210,-14,False
2025-01-08,WAS,PHI,103,109,51,36,26,21,44.7,45.5,43.3,34.1,212,-6,False
2025-01-06,BRK,IND,99,113,51,35,23,22,41.8,50.6,30.3,38.7,212,-14,False
2025-01-06,CHI,SAS,114,110,47,49,25,31,43.1,46.3,33.3,32.6,224,4,True
2025-01-06,DAL,MEM,104,119,50,55,25,24,40.8,45.5,36.1,34.3,223,-15,False
2025-01-06,DET,POR,118,115,45,38,23,32,44.7,53.3,34.9,45.7,233,3,True
2025-01-06,IND,BRK,113,99,35,51,22,23,50.6,41.8,38.7,30.3,212,14,True
2025-01-06,LAC,MIN,106,108,49,55,23,24,41.6,44.6,34.3,41.0,214,-2,False
2025-01-06,MEM,DAL,119,104,55,50,24,25,45.5,40.8,34.3,36.1,223,15,True
2025-01-06,MIA,SAC,118,123,53,60,25,30,42.2,41.7,26.2,34.2,241,-5,False
2025-01-06,MIL,TOR,128,104,46,35,37,27,57.3,45.1,50.0,25.7,232,24,True
2025-01-06,MIN,LAC,108,106,55,49,24,23,44.6,41.6,41.0,34.3,214,2,True
2025-01-06,NYK,ORL,94,103,38,39,16,23,44.4,50.0,18.2,35.5,197,-9,False
2025-01-06,ORL,NYK,103,94,39,38,23,16,50.0,44.4,35.5,18.2,197,9,True
2025-01-06,PHI,PHO,99,109,46,44,20,32,39.1,50.6,37.5,45.2,208,-10,False
2025-01-06,PHO,PHI,109,99,44,46,32,20,50.6,39.1,45.2,37.5,208,10,True
2025-01-06,POR,DET,115,118,38,45,32,23,53.3,44.7,45.7,34.9,233,-3,False
2025-01-06,SAC,MIA,123,118,60,53,30,25,41.7,42.2,34.2,26.2,241,5,True
2025-01-06,SAS,CHI,110,114,49,47,31,25,46.3,43.1,32.6,33.3,224,-4,False
2025-01-06,TOR,MIL,104,128,35,46,27,37,45.1,57.3,25.7,50.0,232,-24,False
2024-12-13,BRK,MEM,119,135,41,49,30,33,45.7,52.5,37.7,47.2,254,-16,False
2024-12-13,CHI,CHO,109,95,52,54,27,22,39.8,35.7,27.5,17.4,204,14,True
2024-12-13,CHO,CHI,95,109,54,52,22,27,35.7,39.8,17.4,27.5,204,-14,False
2024-12-13,CLE,WAS,115,105,50,44,27,24,39.6,47.7,30.0,35.0,220,10,True
2024-12-13,DEN,LAC,120,98,46,31,23,24,54.5,44.6,34.5,34.1,218,22,True
2024-12-13,IND,PHI,121,107,41,47,35,18,51.6,43.5,36.8,40.0,228,14,True
2024-12-13,LAC,DEN,98,120,31,46,24,23,44.6,54.5,34.1,34.5,218,-22,False
2024-12-13,LAL,MIN,87,97,53,48,17,18,38.4,40.2,28.6,28.1,184,-10,False
2024-12-13,MEM,BRK,135,119,49,41,33,30,52.5,45.7,47.2,37.7,254,16,True
2024-12-13,MIN,LAL,97,87,48,53,18,17,40.2,38.4,28.1,28.6,184,10,True
2024-12-13,PHI,IND,107,121,47,41,18,35,43.5,51.6,40.0,36.8,228,-14,False
2024-12-13,PHO,UTA,134,126,37,34,36,30,52.8,55.8,48.9,56.4,260,8,True
2024-12-13,POR,SAS,116,118,36,41,25,32,51.2,51.8,39.0,46.7,234,-2,False
2024-12-13,SAS,POR,118,116,41,36,32,25,51.8,51.2,46.7,39.0,234,2,True
2024-12-13,UTA,PHO,126,134,34,37,30,36,55.8,52.8,56.4,48.9,260,-8,False
2024-12-13,WAS,CLE,105,115,44,50,24,27,47.7,39.6,35.0,30.0,220,-10,False
2024-11-11,BRK,NOP,107,105,46,45,24,31,42.9,44.7,45.2,33.3,212,2,True
2024-11-11,CHI,CLE,113,119,51,43,26,26,49.4,44.3,36.8,33.3,232,-6,False
2024-11-11,CLE,CHI,119,113,43,51,26,26,44.3,49.4,33.3,36.8,232,6,True
2024-11-11,HOU,WAS,107,92,58,34,13,21,46.0,40.9,21.7,35.5,199,15,True
2024-11-11,LAC,OKC,128,134,47,29,31,31,55.0,51.6,54.1,39.1,262,-6,False
2024-11-11,NOP,BRK,105,107,45,46,31,24,44.7,42.9,33.3,45.2,212,-2,False
2024-11-11,OKC,LAC,134,128,29,47,31,31,51.6,55.0,39.1,54.1,262,6,True
2024-11-11,SAC,SAS,96,116,37,44,18,31,42.9,50.6,26.3,47.8,212,-20,False
2024-11-11,SAS,SAC,116,96,44,37,31,18,50.6,42.9,47.8,26.3,212,20,True
2024-11-11,WAS,HOU,92,107,34,58,21,13,40.9,46.0,35.5,21.7,199,-15,False
2025-01-21,BRK,NYK,95,99,47,42,21,29,37.2,46.0,30.0,28.6,194,-4,False
2025-01-21,DEN,PHI,144,109,51,25,39,34,61.2,45.8,51.6,39.5,253,35,True
2025-01-21,LAL,WAS,111,88,50,46,30,25,47.8,35.8,32.4,25.6,199,23,True
2025-01-21,MIA,POR,107,116,45,47,26,25,44.1,49.4,33.3,34.9,223,-9,False
2025-01-21,NYK,BRK,99,95,42,47,29,21,46.0,37.2,28.6,30.0,194,4,True
2025-01-21,ORL,TOR,93,109,48,42,16,29,41.2,53.4,29.0,54.2,202,-16,False
2025-01-21,PHI,DEN,109,144,25,51,34,39,45.8,61.2,39.5,51.6,253,-35,False
2025-01-21,POR,MIA,116,107,47,45,25,26,49.4,44.1,34.9,33.3,223,9,True
2025-01-21,TOR,ORL,109,93,42,48,29,16,53.4,41.2,54.2,29.0,202,16,True
2025-01-21,WAS,LAL,88,111,46,50,25,30,35.8,47.8,25.6,32.4,199,-23,False
2025-01-19,BRK,OKC,101,127,41,43,25,37,42.5,55.2,27.9,44.2,228,-26,False
2025-01-19,CHI,POR,102,113,36,50,21,21,44.4,47.2,27.6,29.0,215,-11,False
2025-01-19,DEN,ORL,113,100,57,39,24,30,51.9,37.3,28.0,29.3,213,13,True
2025-01-19,LAC,LAL,116,102,38,33,27,26,52.8,50.0,36.7,33.3,218,14,True
2025-01-19,LAL,LAC,102,116,33,38,26,27,50.0,52.8,33.3,36.7,218,-14,False
2025-01-19,MIA,SAS,128,107,49,44,35,28,52.6,45.1,54.5,37.5,235,21,True
2025-01-19,MIL,PHI,123,109,48,38,31,26,49.4,45.3,37.8,35.6,232,14,True
2025-01-19,OKC,BRK,127,101,43,41,37,25,55.2,42.5,44.2,27.9,228,26,True
2025-01-19,ORL,DEN,100,113,39,57,30,24,37.3,51.9,29.3,28.0,213,-13,False
2025-01-19,PHI,MIL,109,123,38,48,26,31,45.3,49.4,35.6,37.8,232,-14,False
2025-01-19,POR,CHI,113,102,50,36,21,21,47.2,44.4,29.0,27.6,215,11,True
2025-01-19,SAC,WAS,123,100,51,46,28,19,48.4,36.0,30.8,23.8,223,23,True
2025-01-19,SAS,MIA,107,128,44,49,28,35,45.1,52.6,37.5,54.5,235,-21,False
2025-01-19,WAS,SAC,100,123,46,51,19,28,36.0,48.4,23.8,30.8,223,-23,False
2024-12-30,CHI,CHO,115,108,63,56,31,23,37.5,41.6,30.0,23.3,223,7,True
2024-12-30,CHO,CHI,108,115,56,63,23,31,41.6,37.5,23.3,30.0,223,-7,False
2024-12-30,CLE,GSW,113,95,54,55,25,20,45.8,33.3,38.3,23.7,208,18,True
2024-12-30,DAL,SAC,100,110,36,58,17,25,42.1,42.0,38.7,31.2,210,-10,False
2024-12-30,DEN,UTA,132,121,51,37,38,28,50.5,51.2,30.0,34.2,253,11,True
2024-12-30,GSW,CLE,95,113,55,54,20,25,33.3,45.8,23.7,38.3,208,-18,False
2024-12-30,LAC,NOP,116,113,40,35,24,30,47.7,51.2,35.1,48.6,229,3,True
2024-12-30,NOP,LAC,113,116,35,40,30,24,51.2,47.7,48.6,35.1,229,-3,False
2024-12-30,NYK,WAS,126,106,54,46,34,25,45.9,42.4,34.1,27.9,232,20,True
2024-12-30,PHI,POR,125,103,32,33,20,23,57.3,48.1,45.8,22.2,228,22,True
2024-12-30,POR,PHI,103,125,33,32,23,20,48.1,57.3,22.2,45.8,228,-22,False
2024-12-30,SAC,DAL,110,100,58,36,25,17,42.0,42.1,31.2,38.7,210,10,True
2024-12-30,UTA,DEN,121,132,37,51,28,38,51.2,50.5,34.2,30.0,253,-11,False
2024-12-30,WAS,NYK,106,126,46,54,25,34,42.4,45.9,27.9,34.1,232,-20,False
2024-11-23,CHI,MEM,131,142,35,49,29,38,50.5,57.3,45.2,45.2,273,-11,False
2024-11-23,CHO,MIL,119,125,48,51,22,20,41.0,48.3,40.4,48.6,244,-6,False
2024-11-23,DEN,LAL,127,102,48,32,37,27,61.0,44.3,50.0,36.1,229,25,True
2024-11-23,DET,ORL,100,111,34,44,16,25,46.7,46.0,39.4,30.8,211,-11,False
2024-11-23,GSW,SAS,94,104,49,48,29,29,37.9,44.7,31.8,27.7,198,-10,False
2024-11-23,HOU,POR,98,104,43,53,17,16,35.6,37.8,25.0,40.9,202,-6,False
2024-11-23,LAL,DEN,102,127,32,48,27,37,44.3,61.0,36.1,50.0,229,-25,False
2024-11-23,MEM,CHI,142,131,49,35,38,29,57.3,50.5,45.2,45.2,273,11,True
2024-11-23,MIL,CHO,125,119,51,48,20,22,48.3,41.0,48.6,40.4,244,6,True
2024-11-23,NYK,UTA,106,121,40,52,25,30,39.0,50.6,33.3,55.9,227,-15,False
2024-11-23,ORL,DET,111,100,44,34,25,16,46.0,46.7,30.8,39.4,211,11,True
2024-11-23,POR,HOU,104,98,53,43,16,17,37.8,35.6,40.9,25.0,202,6,True
2024-11-23,SAS,GSW,104,94,48,49,29,29,44.7,37.9,27.7,31.8,198,10,True
2024-11-23,UTA,NYK,121,106,52,40,30,25,50.6,39.0,55.9,33.3,227,15,True
2024-11-07,CHI,MIN,119,135,32,40,30,29,53.4,54.8,41.7,42.1,254,-16,False
2024-11-07,MIL,UTA,123,100,41,39,20,24,51.2,42.9,42.9,41.5,223,23,True
2024-11-07,MIN,CHI,135,119,40,32,29,30,54.8,53.4,42.1,41.7,254,16,True
2024-11-07,POR,SAS,105,118,41,45,23,35,47.7,53.7,28.1,41.0,223,-13,False
2024-11-07,SAS,POR,118,105,45,41,35,23,53.7,47.7,41.0,28.1,223,13,True
2024-11-07,UTA,MIL,100,123,39,41,24,20,42.9,51.2,41.5,42.9,223,-23,False
2024-12-05,CHI,SAS,139,124,50,41,36,26,57.8,46.3,45.9,28.6,263,15,True
2024-12-05,CHO,NYK,101,125,40,43,27,29,44.9,53.9,38.5,54.5,226,-24,False
2024-12-05,CLE,DEN,126,114,47,49,32,25,50.0,47.9,45.8,25.0,240,12,True
2024-12-05,DAL,WAS,137,101,58,39,27,25,53.9,39.4,52.6,32.5,238,36,True
2024-12-05,DEN,CLE,114,126,49,47,25,32,47.9,50.0,25.0,45.8,240,-12,False
2024-12-05,GSW,HOU,99,93,54,45,19,20,41.9,37.6,32.1,26.3,192,6,True
2024-12-05,HOU,GSW,93,99,45,54,20,19,37.6,41.9,26.3,32.1,192,-6,False
2024-12-05,MEM,SAC,115,110,49,46,27,19,47.5,39.8,34.2,22.9,225,5,True
2024-12-05,NOP,PHO,126,124,44,46,23,32,49.5,50.6,38.9,37.8,250,2,True
2024-12-05,NYK,CHO,125,101,43,40,29,27,53.9,44.9,54.5,38.5,226,24,True
2024-12-05,OKC,TOR,129,92,55,51,28,24,48.0,35.6,36.2,24.4,221,37,True
2024-12-05,PHO,NOP,124,126,46,44,32,23,50.6,49.5,37.8,38.9,250,-2,False
2024-12-05,SAC,MEM,110,115,46,49,19,27,39.8,47.5,22.9,34.2,225,-5,False
2024-12-05,SAS,CHI,124,139,41,50,26,36,46.3,57.8,28.6,45.9,263,-15,False
2024-12-05,TOR,OKC,92,129,51,55,24,28,35.6,48.0,24.4,36.2,221,-37,False
2024-12-05,WAS,DAL,101,137,39,58,25,27,39.4,53.9,32.5,52.6,238,-36,False
2024-11-26,CHI,WAS,127,108,50,43,29,27,50.0,42.9,35.0,27.0,235,19,True
2024-11-26,HOU,MIN,117,111,44,52,31,21,45.5,42.9,40.5,23.7,228,6,True
2024-11-26,LAL,PHO,100,127,42,46,25,31,43.5,51.5,23.5,40.5,227,-27,False
2024-11-26,MIA,MIL,103,106,38,41,26,23,45.5,46.8,34.5,47.6,209,-3,False
2024-11-26,MIL,MIA,106,103,41,38,23,26,46.8,45.5,47.6,34.5,209,3,True
2024-11-26,MIN,HOU,111,117,52,44,21,31,42.9,45.5,23.7,40.5,228,-6,False
2024-11-26,PHO,LAL,127,100,46,42,31,25,51.5,43.5,40.5,23.5,227,27,True
2024-11-26,SAS,UTA,128,115,39,41,30,24,48.4,51.2,37.5,37.1,243,13,True
2024-11-26,UTA,SAS,115,128,41,39,24,30,51.2,48.4,37.1,37.5,243,-13,False
2024-11-26,WAS,CHI,108,127,43,50,27,29,42.9,50.0,27.0,35.0,235,-19,False
2024-11-21,CHO,DET,123,121,43,56,23,30,47.3,42.4,45.5,35.4,244,2,True
2024-11-21,DET,CHO,121,123,56,43,30,23,42.4,47.3,35.4,45.5,244,-2,False
2024-11-21,LAL,ORL,118,119,36,48,21,31,50.6,47.3,41.9,37.5,237,-1,False
2024-11-21,MIN,TOR,105,110,40,43,16,22,41.2,51.4,34.3,30.4,215,-5,False
2024-11-21,ORL,LAL,119,118,48,36,31,21,47.3,50.6,37.5,41.9,237,1,True
2024-11-21,SAS,UTA,126,118,51,49,32,22,46.6,41.8,28.1,28.9,244,8,True
2024-11-21,TOR,MIN,110,105,43,40,22,16,51.4,41.2,30.4,34.3,215,5,True
2024-11-21,UTA,SAS,118,126,49,51,22,32,41.8,46.6,28.9,28.1,244,-8,False
2024-12-03,CHO,PHI,104,110,47,31,22,26,44.2,46.3,38.2,40.0,214,-6,False
2024-12-03,CLE,WAS,118,87,45,52,31,18,48.3,38.6,34.8,15.4,205,31,True
2024-12-03,DAL,MEM,121,116,49,39,24,27,48.1,46.4,40.6,32.5,237,5,True
2024-12-03,DEN,GSW,119,115,38,48,32,36,50.6,46.3,45.8,31.6,234,4,True
2024-12-03,DET,MIL,107,128,41,36,22,26,46.0,56.2,33.3,56.1,235,-21,False
2024-12-03,GSW,DEN,115,119,48,38,36,32,46.3,50.6,31.6,45.8,234,-4,False
2024-12-03,HOU,SAC,111,120,53,34,14,33,44.1,51.6,35.9,46.7,231,-9,False
2024-12-03,IND,TOR,111,122,34,42,21,28,45.2,54.3,40.0,39.4,233,-11,False
2024-12-03,LAC,POR,127,105,35,29,29,25,55.3,51.2,51.4,34.5,232,22,True
2024-12-03,MEM,DAL,116,121,39,49,27,24,46.4,48.1,32.5,40.6,237,-5,False
2024-12-03,MIL,DET,128,107,36,41,26,22,56.2,46.0,56.1,33.3,235,21,True
2024-12-03,NYK,ORL,121,106,39,38,30,20,50.6,43.7,42.9,23.1,227,15,True
2024-12-03,OKC,UTA,133,106,34,36,32,21,52.0,54.3,36.2,37.1,239,27,True
2024-12-03,ORL,NYK,106,121,38,39,20,30,43.7,50.6,23.1,42.9,227,-15,False
2024-12-03,PHI,CHO,110,104,31,47,26,22,46.3,44.2,40.0,38.2,214,6,True
2024-12-03,PHO,SAS,104,93,44,53,26,26,48.7,35.0,34.4,18.2,197,11,True
2024-12-03,POR,LAC,105,127,29,35,25,29,51.2,55.3,34.5,51.4,232,-22,False
2024-12-03,SAC,HOU,120,111,34,53,33,14,51.6,44.1,46.7,35.9,231,9,True
2024-12-03,SAS,PHO,93,104,53,44,26,26,35.0,48.7,18.2,34.4,197,-11,False
2024-12-03,TOR,IND,122,111,42,34,28,21,54.3,45.2,39.4,40.0,233,11,True
2024-12-03,UTA,OKC,106,133,36,34,21,32,54.3,52.0,37.1,36.2,239,-27,False
2024-12-03,WAS,CLE,87,118,52,45,18,31,38.6,48.3,15.4,34.8,205,-31,False
2024-12-20,CHO,PHI,98,108,44,39,22,30,46.2,49.4,32.3,36.4,206,-10,False
2024-12-20,CLE,MIL,124,101,48,45,30,23,50.5,47.1,42.6,37.0,225,23,True
2024-12-20,MIA,OKC,97,104,41,48,20,24,43.4,45.3,30.0,41.2,201,-7,False
2024-12-20,MIL,CLE,101,124,45,48,23,30,47.1,50.5,37.0,42.6,225,-23,False
2024-12-20,OKC,MIA,104,97,48,41,24,20,45.3,43.4,41.2,30.0,201,7,True
2024-12-20,PHI,CHO,108,98,39,44,30,22,49.4,46.2,36.4,32.3,206,10,True
2025-01-24,CHO,POR,97,102,46,47,20,17,37.6,40.5,29.0,28.9,199,-5,False
2025-01-24,CLE,PHI,129,132,37,43,30,23,50.0,50.6,48.1,53.8,261,-3,False
2025-01-24,MEM,NOP,139,126,43,35,38,30,55.4,54.2,45.2,41.2,265,13,True
2025-01-24,NOP,MEM,126,139,35,43,30,38,54.2,55.4,41.2,45.2,265,-13,False
2025-01-24,PHI,CLE,132,129,43,37,23,30,50.6,50.0,53.8,48.1,261,3,True
2025-01-24,POR,CHO,102,97,47,46,17,20,40.5,37.6,28.9,29.0,199,5,True
2025-01-16,CLE,OKC,114,134,49,39,32,25,46.7,50.5,31.0,34.0,248,-20,False
2025-01-16,DET,IND,100,111,55,40,22,28,39.6,46.1,25.0,43.3,211,-11,False
2025-01-16,HOU,SAC,127,132,46,44,24,32,52.7,50.0,36.4,42.4,259,-5,False
2025-01-16,IND,DET,111,100,40,55,28,22,46.1,39.6,43.3,25.0,211,11,True
2025-01-16,LAC,POR,118,89,50,37,23,24,56.4,37.4,43.5,26.5,207,29,True
2025-01-16,OKC,CLE,134,114,39,49,25,32,50.5,46.7,34.0,31.0,248,20,True
2025-01-16,PHO,WAS,130,123,47,45,33,28,51.8,50.0,48.5,31.7,253,7,True
2025-01-16,POR,LAC,89,118,37,50,24,23,37.4,56.4,26.5,43.5,207,-29,False
2025-01-16,SAC,HOU,132,127,44,46,32,24,50.0,52.7,42.4,36.4,259,5,True
2025-01-16,WAS,PHO,123,130,45,47,28,33,50.0,51.8,31.7,48.5,253,-7,False
2024-10-31,DAL,HOU,102,108,37,50,21,21,45.9,41.2,33.3,23.5,210,-6,False
2024-10-31,HOU,DAL,108,102,50,37,21,21,41.2,45.9,23.5,33.3,210,6,True
2024-10-31,LAC,PHO,119,125,48,39,27,29,48.4,51.2,34.3,46.2,244,-6,False
2024-10-31,MEM,MIL,122,99,56,38,26,20,52.4,42.7,28.6,21.4,221,23,True
2024-10-31,MIL,MEM,99,122,38,56,20,26,42.7,52.4,21.4,28.6,221,-23,False
2024-10-31,PHO,LAC,125,119,39,48,29,27,51.2,48.4,46.2,34.3,244,6,True
2024-10-31,SAS,UTA,106,88,42,53,25,19,41.3,39.0,27.9,21.9,194,18,True
2024-10-31,UTA,SAS,88,106,53,42,19,25,39.0,41.3,21.9,27.9,194,-18,False
2024-12-10,DAL,OKC,104,118,44,52,25,29,47.5,45.5,41.7,40.0,222,-14,False
2024-12-10,MIL,ORL,114,109,37,46,27,19,54.5,44.1,36.7,22.2,223,5,True
2024-12-10,OKC,DAL,118,104,52,44,29,25,45.5,47.5,40.0,41.7,222,14,True
2024-12-10,ORL,MIL,109,114,46,37,19,27,44.1,54.5,22.2,36.7,223,-5,False
2024-11-14,DAL,UTA,113,115,30,40,25,25,50.6,50.6,30.8,38.2,228,-2,False
2024-11-14,UTA,DAL,115,113,40,30,25,25,50.6,50.6,38.2,30.8,228,2,True
2024-12-22,DEN,NOP,132,129,54,43,34,37,50.5,46.3,30.3,30.0,261,3,True
2024-12-22,HOU,TOR,114,110,53,42,18,33,44.9,45.7,25.0,39.5,224,4,True
2024-12-22,IND,SAC,122,95,50,47,36,21,58.1,36.5,43.6,31.6,217,27,True
2024-12-22,NOP,DEN,129,132,43,54,37,34,46.3,50.5,30.0,30.3,261,-3,False
2024-12-22,SAC,IND,95,122,47,50,21,36,36.5,58.1,31.6,43.6,217,-27,False
2024-12-22,TOR,HOU,110,114,42,53,33,18,45.7,44.9,39.5,25.0,224,-4,False
2025-01-13,DET,NYK,124,119,39,42,20,26,50.0,50.0,44.1,40.5,243,5,True
2025-01-13,GSW,TOR,101,104,46,44,23,28,39.8,47.7,34.8,41.4,205,-3,False
2025-01-13,HOU,MEM,120,118,40,31,28,15,50.6,52.9,51.6,43.8,238,2,True
2025-01-13,LAC,MIA,109,98,48,49,28,22,48.4,38.8,36.1,32.7,207,11,True
2025-01-13,LAL,SAS,102,126,40,41,24,30,44.8,53.3,31.8,37.1,228,-24,False
2025-01-13,MEM,HOU,118,120,31,40,15,28,52.9,50.6,43.8,51.6,238,-2,False
2025-01-13,MIA,LAC,98,109,49,48,22,28,38.8,48.4,32.7,36.1,207,-11,False
2025-01-13,MIN,WAS,120,106,53,34,20,27,49.4,44.0,37.8,42.5,226,14,True
2025-01-13,NYK,DET,119,124,42,39,26,20,50.0,50.0,40.5,44.1,243,-5,False
2025-01-13,SAS,LAL,126,102,41,40,30,24,53.3,44.8,37.1,31.8,228,24,True
2025-01-13,TOR,GSW,104,101,44,46,28,23,47.7,39.8,41.4,34.8,205,3,True
2025-01-13,WAS,MIN,106,120,34,53,27,20,44.0,49.4,42.5,37.8,226,-14,False
2025-01-11,DET,TOR,123,114,46,45,35,27,52.4,43.5,57.6,42.1,237,9,True
2025-01-11,MEM,MIN,127,125,46,41,25,37,44.4,56.6,39.0,40.5,252,2,True
2025-01-11,MIA,POR,119,98,43,51,31,24,47.8,37.9,43.2,28.9,217,21,True
2025-01-11,MIN,MEM,125,127,41,46,37,25,56.6,44.4,40.5,39.0,252,-2,False
2025-01-11,PHO,UTA,114,106,38,50,26,26,51.2,43.8,35.1,21.4,220,8,True
2025-01-11,POR,MIA,98,119,51,43,24,31,37.9,47.8,28.9,43.2,217,-21,False
2025-01-11,TOR,DET,114,123,45,46,27,35,43.5,52.4,42.1,57.6,237,-9,False
2025-01-11,UTA,PHO,106,114,50,38,26,26,43.8,51.2,21.4,35.1,220,-8,False
2024-12-17,MIL,OKC,97,81,52,43,25,13,42.0,33.7,42.5,15.6,178,16,True
2024-12-17,OKC,MIL,81,97,43,52,13,25,33.7,42.0,15.6,42.5,178,-16,False
2024-12-09,NYK,TOR,113,108,40,51,32,23,51.2,44.8,42.5,37.1,221,5,True
2024-12-09,TOR,NYK,108,113,51,40,23,32,44.8,51.2,37.1,42.5,221,-5,False
2025-01-26,OKC,POR,118,108,43,44,24,21,47.2,40.7,33.3,45.0,226,10,True
2025-01-26,POR,OKC,108,118,44,43,21,24,40.7,47.2,45.0,33.3,226,-10,False
